缤	bbaa
濒	bbai
滨	bbaooa
髌	bbia
傧	bbio
镔	bbioo
摈	bbiuoo
豳	bbiv
宾	bbooui
斌	bbovvv
邠	bbuo
膑	bbuooa
鬓	bbvi
槟	bbvo
殡	bbvu
玢	bbvv
彬	bbvvuu
骠	bcaa
骉	bcaaa
瀌	bcao
婊	bcauvv
幖	bcia
蔈	bcii
藨	bciio
镖	bcio
镳	bcioo
儦	bciov
摽	bciu
俵	bciv
彪	bcivuu
裱	bcoavv
熛	bcou
瘭	bcov
飚	bcua
飑	bcuau
鳔	bcuav
脿	bcuv
膘	bcuvia
髟	bcvi
飙	bcvu
杓	bcvua
表	bcvvua
标	bcvvvi
别	bdoaii
鳖	bdou
蹩	bdouo
憋	bdouoa
瘪	bdov
绊	bfaaou
阪	bfai
湴	bfao
办	bfauoo
蝂	bfia
伴	bfio
钣	bfiou
扳	bfiu
拌	bfiuo
扮	bfiuu
搬	bfiuuu
昄	bfoi
粄	bfoo
半	bfouvv
瓣	bfov
𨭉	bfovi
瘢	bfovu
癍	bfovv
版	bfuiuu
颁	bfuo
攽	bfuou
般	bfuu
舨	bfuuu
靽	bfvi
坂	bfvo
板	bfvu
斑	bfvv
班	bfvvou
屏	bgavou
蛃	bgia
摒	bgiuav
昺	bgoi
炳	bgou
并	bgouvv
冰	bgov
禀	bgovi
病	bgovvi
饼	bgua
兵	bguiuo
秉	bguv
丙	bgvi
邴	bgvia
柄	bgvvia
败	bhaouv
拜	bhiu
伯	bhiui
摆	bhiuia
掰	bhiuu
捭	bhiuui
佰	bhiv
呗	bhoaoo
白	bhuiav
稗	bhuvui
柏	bhvu
百	bhvuoi
蔀	bjii
卜	bjio
钚	bjiov
堡	bjiovo
钸	bjiovu
捕	bjiu
步	bjiviu
补	bjoaio
晡	bjoi
卟	bjoio
怖	bjoo
哺	bjov
部	bjovai
瓿	bjovv
簿	bjuvav
逋	bjvi
醭	bjvii
埠	bjvo
埗	bjvoi
埔	bjvov
㘵	bjvovu
布	bjvuia
不	bjvuio
纰	bkaa
陛	bkai
泌	bkao
赑	bkaoa
婢	bkau
濞	bkaui
妼	bkauo
妣	bkauv
滗	bkauvo
壁	bkav
嬖	bkava
沘	bkavau
辟	bkavo
避	bkavoa
屄	bkavoo
襞	bkavov
臂	bkavu
璧	bkavv
弼	bkavvu
睥	bkia
髀	bkiau
畀	bkiav
蓖	bkii
薜	bkiia
苾	bkiio
蔽	bkiiou
荸	bkiiu
萆	bkiiui
荜	bkiiv
铋	bkio
佖	bkioa
俾	bkiu
裨	bkoa
邲	bkoaa
诐	bkoaau
必	bkoaou
闭	bkoi
跸	bkoiv
愎	bkoo
咇	bkooa
弊	bkou
鄙	bkoua
敝	bkouu
庇	bkov
哔	bkova
吡	bkovau
痹	bkovi
庳	bkovu
匕	bkua
狴	bkuav
鲾	bkuavo
币	bkui
鼻	bkuii
贲	bkuo
彼	bkuu
舭	bkuuv
秘	bkuv
箅	bkuvi
馝	bkuvo
篦	bkuvu
笔	bkuvuv
秕	bkuvv
筚	bkuvva
毙	bkva
毖	bkvao
比	bkvaua
毕	bkvauo
坒	bkvav
逼	bkvo
皕	bkvu
觱	bkvuu
碧	bkvv
珌	bkvvo
驳	blaa
波	blaaui
泊	blau
渤	blauo
浡	blauoo
剥	blav
擘	blavi
檗	blavv
嶓	blia
薄	blii
菠	bliia
蕃	bliiu
钵	blio
铂	bliou
钹	bliov
镈	bliovi
拨	bliuau
播	bliuuo
搏	bliuv
啵	bloa
袯	bloaa
踣	bloi
跛	bloiau
亳	blov
饽	blua
鲌	bluau
帛	blui
魄	bluiu
勃	bluo
鹁	bluou
博	bluovi
脖	bluu
舶	bluuu
膊	bluv
箔	bluva
馞	bluvu
簸	bluvv
僰	blvi
欂	blvii
礴	blvui
桲	blvuo
磻	blvuu
砵	blvuv
玻	blvvau
编	bmaa
缏	bmaai
贬	bmao
𨚕	bmaoa
汴	bmaov
弁	bmaovu
边	bmauoa
蝙	bmia
苄	bmii
萹	bmiio
抃	bmiu
便	bmivia
扁	bmoa
褊	bmoao
遍	bmoaoa
昪	bmoi
窆	bmoo
忭	bmooo
煸	bmou
辩	bmov
辫	bmova
变	bmovao
卞	bmovi
辨	bmovo
鳊	bmua
笾	bmuvau
鞭	bmviiv
匾	bmvo
砭	bmvu
碥	bmvuo
畚	bnaoia
苯	bniivi
锛	bnio
倴	bniv
坌	bnuov
犇	bnuv
笨	bnuvvi
本	bnviuo
栟	bnvo
坋	bnvou
奔	bnvuuo
绑	bpaavv
浜	bpau
蚌	bpia
蒡	bpii
傍	bpio
镑	bpioov
搒	bpiu
谤	bpoaov
𠳐	bpov
膀	bpuovo
榜	bpvo
塝	bpvoo
彭	bpvou
棓	bpvov
磅	bpvu
棒	bpvv
邦	bpvvai
帮	bpvvia
梆	bpvvv
玤	bpvvvv
绷	braauu
崩	briauu
镚	brio
祊	broa
嘣	broi
蹦	broiia
迸	brouoa
堋	brvo
甏	brvov
泵	brvu
甭	brvuua
琫	brvv
巴	bsaiva
妭	bsau
灞	bsav
㞎	bsava
罢	bsia
岜	bsiaa
蚆	bsiaai
芭	bsii
菝	bsiii
茇	bsiiv
钯	bsio
扒	bsiu
把	bsiuai
捌	bsiuo
拔	bsiuvu
吧	bsoaiv
跋	bsoi
叭	bsou
粑	bsoua
羓	bsouai
疤	bsov
鲅	bsua
鲃	bsuaa
魃	bsui
爸	bsuo
八	bsuoo
笆	bsuv
胈	bsuvu
靶	bsvi
坝	bsvo
霸	bsvovi
朳	bsvu
耙	bsvv
陂	bwai
贝	bwaoo
鐾	bwavi
蓓	bwii
倍	bwio
钡	bwioa
背	bwiv
邶	bwiva
悲	bwivo
北	bwivua
辈	bwivv
褙	bwoa
被	bwoaau
悖	bwoo
焙	bwou
糒	bwouv
惫	bwua
狈	bwuaa
备	bwuaia
卑	bwui
鹎	bwuiu
孛	bwuoa
鞴	bwvi
鞁	bwvia
碑	bwvu
椑	bwvui
碚	bwvuo
琲	bwvv
杯	bwvvui
孢	bzai
瀑	bzao
葆	bziii
苞	bziiu
煲	bzioo
保	bziovv
抱	bziu
报	bziuai
龅	bziv
褓	bzoa
暴	bzoi
曝	bzoio
趵	bzoiu
宝	bzoovv
爆	bzou
炮	bzouu
褒	bzov
饱	bzua
勹	bzuaa
包	bzuaav
刨	bzuai
鲍	bzuau
鸨	bzuaua
豹	bzuo
胞	bzuu
雹	bzvoua
枹	bzvu
缞	cbaa
漼	cbai
淬	cbao
翠	cbaoov
崔	cbiaio
萃	cbii
催	cbiiai
摧	cbiu
悴	cboo
啐	cboovi
粹	cbou
瘁	cbov
衰	cbovi
脆	cbuuav
毳	cbuv
榱	cbvo
璀	cbvvia
凑	cdovvv
腠	cduvvv
辏	cdvavv
楱	cdvv
测	ceaaoi
侧	ceiaoi
恻	ceooao
册	ceuaua
策	ceuv
栅	cevu
厕	cevuao
骖	cfaaao
参	cfaouu
孱	cfav
黪	cfia
掺	cfiu
粲	cfiv
餐	cfivio
喰	cfoi
惭	cfoo
惨	cfooao
灿	cfou
䅟	cfuvao
残	cfvuvv
蚕	cfvv
璨	cfvvi
财	chaovi
睬	chia
偲	chii
蔡	chiiua
菜	chiiuo
踩	choiuo
猜	chua
彩	chuo
裁	chuoo
采	chuovv
才	chviuu
材	chvviu
蔟	cjii
促	cjioiv
蹴	cjoiov
粗	cjouia
卒	cjov
猝	cjua
徂	cjuu
簇	cjuvov
酢	cjvi
醋	cjvivi
蹙	cjvu
殂	cjvui
泚	ckai
赐	ckaooi
伺	ckia
茨	ckii
茲	ckiia
茈	ckiii
莿	ckiiv
佽	ckio
雌	ckiv
此	ckivua
祠	ckoa
词	ckoaav
呲	ckoi
跐	ckoii
慈	ckou
兹	ckoua
糍	ckouo
鹚	ckouu
差	ckouv
瓷	ckov
疵	ckovi
次	ckovua
辞	ckuvov
刺	ckviii
磁	ckvu
玼	ckvv
嵯	clia
莝	clii
锉	clio
错	cliovi
挫	cliu
撮	cliuo
搓	cliuou
措	cliuv
鹾	cliv
蹉	cloi
瘥	clov
痤	clovii
脞	clui
酂	cluv
矬	cluvii
厝	clvu
磋	clvuou
瑳	clvv
涔	cnaiai
岑	cniaio
沧	cpaiaa
鸧	cpia
仓	cpiaaa
苍	cpii
伧	cpiia
藏	cpiivu
舱	cpuuia
臧	cpvuvi
层	cravvv
嶒	criaou
蹭	croiou
噌	croo
曾	crouia
擦	csiuoo
拆	csiuuu
嚓	csoooa
礤	csvuii
镩	ctio
撺	ctiu
攒	ctiuuv
蹿	ctoioo
窜	ctooia
爨	ctui
汆	ctuo
篡	ctuvia
皴	cwaoau
蹲	cwoi
忖	cwoovi
吋	cwov
邨	cwva
寸	cwvi
存	cwvuai
村	cwvvio
骢	cyaa
淙	cyaooa
葱	cyii
苁	cyiii
从	cyiiii
丛	cyiivv
悰	cyoooo
熜	cyou
匆	cyuauu
囱	cyui
枞	cyvi
聪	cyviou
琮	cyvv
璁	cyvvu
屮	czai
漕	czavia
螬	czia
艹	czii
草	cziioi
操	cziuoo
糙	czouuv
嘈	czov
肏	czuo
艚	czuuvi
曹	czvioi
𥕢	czvu
槽	czvv
队	dbaiii
怼	dbao
对	dbaovi
镦	dbioov
㨃	dbiu
祋	dboa
兑	dbouua
憝	dbov
敦	dbovu
追	dbuioa
㙂	dbvo
堆	dbvoio
碓	dbvu
汈	dcaa
屌	dcav
刁	dcavv
铞	dcio
铫	dciou
钓	dcioua
掉	dciuiv
叼	dcoa
调	dcoaua
吊	dcoi
窎	dcoo
凋	dcov
鸟	dcua
雕	dcuaio
鲷	dcuau
貂	dcuo
碉	dcvuua
绖	ddaa
陡	ddaivo
叠	ddao
蝶	ddia
蚪	ddiao
螲	ddiaoo
蔸	ddii
钭	ddio
揲	ddiu
抖	ddiuoo
佚	ddiuv
谍	ddoa
读	ddoau
跌	ddoi
昳	ddoiu
蹀	ddoiv
窦	ddoo
斗	ddoouo
痘	ddov
咥	ddova
喋	ddovi
鲽	ddua
牒	ddui
兜	dduiua
爹	dduo
都	dduoai
䏲	dduou
耋	dduov
瓞	dduu
迭	dduv
篼	dduvu
逗	ddvo
豆	ddvoou
堞	ddvov
垤	ddvova
碟	ddvu
楪	ddvv
锝	deiooi
嘚	deouui
的	deuiua
得	deuuoi
德	deuuuo
地	devoai
蛋	dfai
疍	dfaio
淡	dfao
赕	dfaoo
澹	dfau
弹	dfavou
眈	dfia
萏	dfii
但	dfioiv
掸	dfiu
儋	dfiua
担	dfiuoi
诞	dfoa
旦	dfoi
惮	dfoo
啖	dfoou
憺	dfooua
郸	dfou
单	dfouia
疸	dfov
亶	dfovi
瘅	dfovo
丹	dfuaov
胆	dfuo
膻	dfuov
氮	dfuv
箪	dfuvo
聃	dfvi
耽	dfvioa
石	dfvu
殚	dfvuo
鼎	dgia
町	dgiav
盯	dgiavi
萣	dgii
钉	dgio
锭	dgioo
铤	dgiou
仃	dgiv
订	dgoavi
啶	dgoo
定	dgoovi
叮	dgov
疔	dgovv
腚	dguooa
丁	dgvi
酊	dgviv
耵	dgvivi
顶	dgvivu
碇	dgvu
玎	dgvv
绐	dhaa
骀	dhaaa
怠	dhao
迨	dhaoo
逮	dhavoa
贷	dhiv
代	dhivao
黛	dhivi
岱	dhivia
袋	dhivov
傣	dhivv
垈	dhivvo
诒	dhoa
呔	dhov
呆	dhovv
戴	dhuo
待	dhuuvo
轪	dhva
棣	dhvav
带	dhviia
埭	dhvo
歹	dhvu
殆	dhvua
大	dhvuo
玳	dhvv
叇	dhvva
甙	dhvvi
赌	djao
渡	djaovu
妒	djau
渎	djauo
厾	djav
睹	djia
髑	djiai
黩	djiau
芏	djii
镀	djio
督	djivia
阇	djoi
嘟	djou
度	djovao
独	djuaia
牍	djui
肚	djuv
笃	djuva
犊	djuvu
蠹	djvi
堵	djvo
椟	djvu
杜	djvv
毒	djvvaa
缔	dkaa
翟	dkao
滴	dkaovo
涤	dkau
嫡	dkauo
娣	dkauou
媂	dkauov
迪	dkia
睇	dkiao
骶	dkiau
䗖	dkiav
蒂	dkii
荻	dkiiu
菂	dkiiui
镝	dkio
俤	dkiou
抵	dkiu
低	dkiuav
提	dkiuo
谛	dkoa
禘	dkoao
诋	dkoau
踶	dkoi
蹢	dkoio
嘀	dkoo
弟	dkou
递	dkouo
羝	dkouu
帝	dkov
遆	dkovo
底	dkovua
狄	dkua
邸	dkuaa
氐	dkuav
籴	dkuo
觌	dkuoi
敌	dkuv
第	dkuvav
笛	dkuvi
髢	dkvi
鞮	dkvio
坻	dkvo
堤	dkvooi
砥	dkvu
柢	dkvua
碲	dkvuo
䃅	dkvuou
玓	dkvv
𤧛	dkvvo
杕	dkvvu
驮	dlaa
缍	dlaau
隳	dlai
隋	dlaiv
堕	dlaivo
剟	dlao
沲	dlau
铎	dlioao
掇	dliu
咄	dloa
裰	dloaa
跺	dloi
踱	dloiov
惰	dloo
哆	dlou
哚	dloua
亸	dlovo
剁	dlua
饳	dluaa
多	dluaua
朵	dluavv
躲	dlui
舵	dluu
垛	dlvo
㙍	dlvoa
柁	dlvoo
埵	dlvou
夺	dlvuvi
阽	dmai
淀	dmao
滇	dmau
殿	dmavua
典	dmia
巅	dmiau
电	dmiavv
佃	dmii
钿	dmio
垫	dmiu
掂	dmiuo
点	dmivoo
扂	dmoa
踮	dmoi
惦	dmoo
奠	dmou
癫	dmov
癜	dmova
店	dmoviv
甸	dmua
颠	dmuovu
簟	dmuv
坫	dmvo
磹	dmvu
碘	dmvuia
玷	dmvv
靛	dmvvo
琔	dmvvoo
扽	dniuva
凼	dpaaii
蟷	dpia
荡	dpii
菪	dpiio
铛	dpio
当	dpioav
党	dpioua
挡	dpiu
谠	dpoa
裆	dpoaio
宕	dpoo
筜	dpuvio
𣗋	dpvi
档	dpviou
垱	dpvo
砀	dpvu
珰	dpvv
铥	dqiouv
丢	dquvao
澄	draa
邓	drao
凳	draou
登	draovo
嶝	dria
瞪	driaao
镫	drio
噔	droa
蹬	droi
戥	droiv
灯	drouvi
簦	druvao
等	druvvo
磴	drvuao
璒	drvv
溚	dsai
沓	dsao
妲	dsauoi
迚	dsia
荙	dsii
𨱏	dsio
搭	dsiu
打	dsiuvi
褡	dsoa
嗒	dsoi
跶	dsoiv
怛	dsoo
嗲	dsou
炟	dsouo
哒	dsov
瘩	dsovii
笪	dsuv
答	dsuviv
鞑	dsvi
靼	dsvio
垯	dsvo
耷	dsvu
达	dsvuoa
缎	dtaaui
耑	dtia
锻	dtioui
煅	dtou
断	dtouuu
端	dtov
段	dtuiua
簖	dtuv
短	dtuvvo
塅	dtvo
椴	dtvuiv
瑖	dtvv
沌	dwavai
盹	dwia
囤	dwiav
钝	dwiova
蹾	dwoio
惇	dwoo
炖	dwou
吨	dwovai
盾	dwuu
遁	dwuuo
趸	dwva
顿	dwvavu
墩	dwvo
砘	dwvu
礅	dwvuov
洞	dyaiav
峒	dyia
岽	dyiav
侗	dyii
董	dyiiuv
恫	dyoo
懂	dyooii
咚	dyou
冻	dyov
冬	dyuaoo
胴	dyui
胨	dyuv
氡	dyuvu
鸫	dyva
东	dyvaiu
垌	dyvo
硐	dyvu
栋	dyvv
动	dyvvau
刀	dzauu
导	dzav
帱	dzia
捣	dziu
捯	dziuv
倒	dzivao
祷	dzoa
叨	dzoau
蹈	dzoi
悼	dzoo
忉	dzooa
道	dzouoa
盗	dzov
鱽	dzua
岛	dzuaia
舠	dzuu
稻	dzuv
氘	dzuvu
到	dzvaii
焘	dzvv
纛	dzvvia
水	ebaa
帨	ebia
睡	ebiauv
说	eboa
谁	eboaio
税	ebuvou
绶	edaauo
收	edaiuv
售	edio
授	ediu
手	ediuu
守	edoo
兽	edou
首	edouui
瘦	edov
熟	edovo
狩	edua
受	eduoao
艏	eduu
寿	edvvvi
涉	eeaivi
赊	eeao
滠	eeav
蛇	eeia
虵	eeiaa
摄	eeiu
拾	eeiui
折	eeiuu
佘	eeiv
畲	eeivi
畬	eeivia
歙	eeivu
舍	eeivvi
设	eeoaua
社	eeoavo
慑	eeoo
麝	eeov
猞	eeua
射	eeuivi
舌	eeuv
赦	eevo
厍	eevu
奓	eevuu
奢	eevuuo
缮	efaa
骟	efaao
汕	efai
陕	efaivo
赡	efao
姗	efau
嬗	efauo
潸	efav
蟮	efia
山	efiaii
苫	efii
芟	efiiu
钐	efio
掞	efiuoo
擅	efiuov
扇	efoa
讪	efoai
禅	efoao
衫	efoau
闪	efoi
晱	efoio
跚	efoiu
煽	efou
鄯	efoua
糁	efouao
剡	efouii
善	efouoo
疝	efov
颤	efovv
鳝	efua
删	efuaii
鳣	efuao
膳	efuo
舢	efuu
埏	efvo
墡	efvoo
杉	efvu
珊	efvvua
蟀	egia
帅	egiuia
摔	egiuov
率	egovaa
甩	eguavv
晒	ehoivi
色	ehua
筛	ehuviu
酾	ehvivi
纾	ejaa
书	ejaaio
疏	ejai
陎	ejaiu
淑	ejaiv
赎	ejao
恕	ejau
婌	ejaui
姝	ejauu
属	ejav
漱	ejavi
沭	ejavo
澍	ejavoo
署	ejia
蜀	ejiau
墅	ejiav
竖	ejii
蔬	ejiia
薯	ejiii
菽	ejiiiv
倏	ejiiu
抒	ejiu
摅	ejiui
舒	ejiv
鄃	ejiva
叔	ejivao
毹	ejivu
暑	ejoi
曙	ejoii
糬	ejou
数	ejouuv
孰	ejov
庶	ejovo
塾	ejovv
殳	ejua
腧	ejui
鼠	ejuiao
黍	ejuv
秫	ejuvv
输	ejva
树	ejvaov
束	ejvi
术	ejvo
述	ejvooa
梳	ejvov
殊	ejvu
戍	ejvuo
枢	ejvv
琡	ejvvi
驶	ekaa
浉	ekai
湿	ekao
湜	ekaoi
虱	ekau
始	ekauao
尸	ekav
屎	ekavo
鸤	ekavu
史	ekia
似	ekiao
峙	ekiav
畤	ekiavo
莳	ekii
蓍	ekiiu
食	ekio
铈	ekioo
师	ekiu
势	ekiua
誓	ekiuo
逝	ekiuoa
什	ekiuoo
拭	ekiuv
仕	ekiv
使	ekivia
侍	ekivo
诗	ekoa
视	ekoai
识	ekoao
谥	ekoaou
祏	ekoav
呞	ekoavo
襫	ekoavv
试	ekoavv
匙	ekoi
嘘	ekoiv
时	ekoivi
是	ekoivi
室	ekoo
实	ekooo
恃	ekoov
嗜	ekou
噬	ekouv
炻	ekouvu
市	ekov
施	ekovu
狮	ekua
鲺	ekuaa
蚀	ekuai
鲥	ekuao
饰	ekuau
氏	ekuav
鼫	ekui
释	ekuo
十	ekuoo
辻	ekuooa
弑	ekuov
失	ekuv
适	ekuvo
舐	ekuvu
矢	ekuvv
筮	ekuvvi
䏡	ekuvvi
轼	ekva
世	ekvi
贳	ekvia
事	ekviav
䴓	ekviu
士	ekvo
邿	ekvoa
螫	ekvoi
埘	ekvooi
柿	ekvov
豕	ekvua
殖	ekvuu
式	ekvv
示	ekvvi
奭	ekvvu
栻	ekvvv
妁	elauua
蒴	elii
铄	elioua
搠	eliu
朔	elou
烁	elouua
槊	elouv
硕	elvuvu
骦	emaa
双	emaoao
孀	emauvo
泷	emav
漺	emavu
霜	emvo
鹴	emvou
礵	emvu
爽	emvuou
渗	enaa
绅	enaai
沈	enao
深	enaoau
渖	enaoo
婶	enau
娠	enauv
申	enia
屾	eniai
瞫	eniav
肾	enii
伸	eniiav
莘	eniio
葚	eniiv
侁	eniuv
谌	enoa
谂	enoai
神	enoaia
诜	enoau
呻	enoi
慎	enoo
审	enooia
燊	enouv
哂	enov
瘆	enova
鲹	enua
胂	enui
身	enuiav
矧	enuv
甡	enuvu
甚	enviuo
砷	envu
蜃	envui
椹	envv
珅	envvi
绱	epaa
汤	epaauu
赏	epio
尚	epioia
裳	epioo
伤	epiu
上	epivvv
晌	epoi
熵	epou
商	epovia
觞	epuauv
垧	epvo
墒	epvoov
殇	epvu
刷	eqavii
唰	eqoavu
耍	eqvuau
绳	eraa
陞	erai
渑	erao
圣	eraovo
嵊	eria
省	eriuia
昇	eroi
晟	eroivu
胜	eruu
升	eruv
甥	eruvi
眚	eruvia
剩	eruvii
乘	eruviv
牲	eruvu
笙	eruvuv
生	eruvvi
声	ervoai
盛	ervu
纱	esaa
鲨	esai
裟	esaio
沙	esaiuo
莎	esii
铩	esio
傻	esiuia
啥	esoivv
唼	esoo
嗄	esov
痧	esovai
煞	esua
刹	esuo
杀	esuovv
歃	esuv
霎	esvo
砂	esvu
厦	esvuvu
涮	etaavu
拴	etiuiv
闩	etoivv
腨	etuiai
栓	etvivv
瞬	ewiauo
吮	ewoaou
顺	ewuivu
舜	ewuo
楯	ewvuuu
灀	exavo
绍	ezaaau
邵	ezau
劭	ezaua
召	ezauo
潲	ezauv
蛸	ezia
苕	ezii
芍	eziiu
捎	eziuio
少	eziuou
哨	ezoi
烧	ezouva
韶	ezov
勺	ezua
艄	ezuu
筲	ezuv
稍	ezuvio
柖	ezva
鞘	ezvi
梢	ezviou
玿	ezvv
缀	fbaa
骓	fbaai
缒	fbaau
坠	fbaivo
隹	fbio
锥	fbioio
揣	fbiu
惴	fbooia
椎	fbvi
赘	fbvvao
覅	fcviua
骤	fdaa
绉	fdaau
纣	fdaav
赒	fdao
洲	fdaouo
妯	fdau
婤	fdauu
粥	fdav
帚	fdavi
昼	fdavo
胄	fdiauu
荮	fdii
㑇	fdiu
诌	fdoa
咒	fdoo
宙	fdooi
啁	fdou
州	fdouoi
皱	fduaau
周	fduavo
繇	fduo
舟	fduu
鸼	fduuu
肘	fduv
籀	fduvi
缶	fduvv
轴	fdva
辀	fdvau
酎	fdvi
碡	fdvu
否	fdvuoo
浙	feaiuu
蔗	feii
锗	feio
哲	feiu
摺	feiua
蛰	feiui
蜇	feiuia
晢	feiuo
褶	feoa
谪	feoao
褚	feoau
啫	feou
着	feouia
鹧	feov
䗪	feovi
戢	feovii
这	feovoa
遮	feovoa
者	feuooi
辄	feva
辙	fevaov
喆	fevo
赭	fevou
磔	fevu
詟	fevuo
柘	fevv
氾	ffaa
贩	ffao
泛	ffauoa
帆	ffia
幡	ffiau
畈	ffiauu
藩	ffiia
范	ffiiaa
蘩	ffiiu
钒	ffio
蹯	ffoi
燔	ffou
烦	ffouvu
凡	ffua
犯	ffuaa
饭	ffuauu
翻	ffuo
番	ffuoi
返	ffuu
反	ffuuao
繁	ffuv
墦	ffvo
樊	ffvu
矾	ffvuu
璠	ffvv
梵	ffvvua
拽	fgiuia
跩	fgoiia
转	fgvavv
择	fhiua
摘	fhiuov
债	fhiv
砦	fhivv
窄	fhoo
宅	fhoouv
寨	fhoov
斋	fhov
瘵	fhovu
祭	fhuavv
缚	fjaa
绋	fjaaa
驸	fjaai
绂	fjaav
附	fjai
洑	fjaiv
赋	fjao
涪	fjaov
赙	fjaovi
浮	fjau
妇	fjauav
滏	fjauo
㳇	fjauou
弗	fjav
艴	fjavu
幅	fjia
幞	fjiai
蝮	fjiau
蜉	fjiauo
蝠	fjiav
佛	fjiava
罘	fjiavu
蚨	fjiavv
芙	fjii
茀	fjiia
䓛	fjiiav
苻	fjiii
茯	fjiiiv
菔	fjiiu
莩	fjiiuo
莆	fjiiv
芾	fjiivi
黼	fjiivi
芣	fjiivu
黻	fjiivu
俯	fjio
扶	fjiu
拂	fjiua
拊	fjiui
俘	fjiuo
抚	fjiuv
伏	fjiv
傅	fjivi
付	fjivio
福	fjoa
袱	fjoai
讣	fjoaio
祓	fjoav
咐	fjoi
跗	fjoii
趺	fjoiv
富	fjoo
怫	fjooa
宓	fjooo
㕮	fjou
腐	fjov
鄜	fjova
府	fjoviv
呋	fjovv
负	fjua
鲋	fjuai
服	fjuaia
孵	fjuau
凫	fjuaua
鳆	fjuauv
匐	fjuav
阜	fjui
父	fjuo
孚	fjuoa
郛	fjuoai
斧	fjuou
腑	fjuov
釜	fjuovv
腹	fjuu
符	fjuv
氟	fjuva
脯	fjuvi
复	fjuvoi
馥	fjuvu
稃	fjuvuo
肤	fjuvv
簠	fjuvvi
辅	fjva
辐	fjvav
覆	fjvi
甫	fjvia
巿	fjviai
敷	fjviu
赴	fjvo
副	fjvoii
砩	fjvu
桴	fjvuo
砆	fjvuv
夫	fjvv
榑	fjvvi
琈	fjvvu
麸	fjvvv
韨	fjvvvu
玞	fjvvvv
纸	fkaa
滍	fkaai
织	fkaao
治	fkaaoo
彘	fkaau
陟	fkai
骘	fkaia
沚	fkaiv
汁	fkau
泜	fkaua
滞	fkav
咫	fkavo
置	fkia
ㄓ	fkiai
帜	fkiao
蜘	fkiau
帙	fkiauv
蛭	fkiava
芝	fkii
芷	fkiii
黹	fkiio
𦭜	fkiiou
茋	fkiiu
锧	fkio
铚	fkiov
值	fkiu
贽	fkiua
絷	fkiuaa
挚	fkiui
掷	fkiuo
伎	fkiuoa
摭	fkiuov
执	fkiuu
扺	fkiuua
鸷	fkiuua
指	fkiuua
止	fkiv
侄	fkiva
祁	fkoaa
祉	fkoai
禔	fkoao
之	fkoaoo
祗	fkoau
祇	fkoaua
趾	fkoi
踯	fkoio
踬	fkoiu
跖	fkoiv
晊	fkoiva
跱	fkoivo
窒	fkoo
忮	fkoou
吱	fkou
只	fkouoo
痔	fkov
痣	fkovv
痓	fkovva
庤	fkovvo
旨	fkua
炙	fkuao
觯	fkuaou
直	fkuo
支	fkuoa
疐	fkuoai
𨙸	fkuoai
豸	fkuoo
膣	fkuooa
质	fkuu
脂	fkuua
卮	fkuuaa
胝	fkuuav
徵	fkuui
肢	fkuuo
制	fkuv
稚	fkuvi
雉	fkuvio
智	fkuvo
知	fkuvoo
秩	fkuvu
稙	fkuvuo
致	fkva
郅	fkvaa
轵	fkvao
轾	fkvav
至	fkvavo
职	fkvi
郦	fkvia
栉	fkvii
酯	fkviu
志	fkvo
址	fkvoi
枳	fkvou
埴	fkvouo
枝	fkvu
植	fkvuo
榰	fkvuov
栀	fkvuuv
桎	fkvv
梽	fkvvo
濯	flaa
缴	flaau
淖	flai
浊	flaiav
浞	flao
叕	flaoa
汋	flau
涿	flav
著	flii
茁	fliia
倬	fliiv
镯	flio
䦃	flioi
拙	fliu
擢	fliua
捉	fliuoi
卓	fliv
桌	flivvv
诼	floa
禚	floao
躅	floi
晫	floii
灼	flou
焯	floui
啄	flov
棹	flvi
酌	flviua
棁	flvo
斫	flvu
琢	flvv
椓	flvvu
奘	fmaivu
幢	fmia
僮	fmio
撞	fmiuov
憧	fmoo
壮	fmov
妆	fmova
戆	fmovo
装	fmovov
庄	fmovv
状	fmovvu
桩	fmvovu
纷	fnaauo
瀵	fnao
翂	fnaou
汾	fnau
𣸣	fnauo
芬	fnii
蕡	fniiu
棻	fniiv
偾	fniu
份	fniuoa
愤	fnoo
粪	fnou
吩	fnouo
粉	fnouuo
鲼	fnua
鼢	fnui
忿	fnuo
分	fnuoau
氛	fnuvuo
酚	fnvi
坟	fnvo
豮	fnvu
奋	fnvuia
焚	fnvv
棼	fnvvu
纺	fpaa
防	fpaiov
妨	fpau
蚄	fpia
芳	fpii
钫	fpio
仿	fpiova
房	fpoa
访	fpoao
昉	fpoi
邡	fpov
方	fpovau
放	fpovuv
鲂	fpua
肪	fpuo
舫	fpuu
彷	fpuuov
牥	fpuv
匚	fpva
枋	fpvo
坊	fpvoov
抓	fqiuuu
挝	fqiuvi
爪	fquuio
髽	fqviii
缝	fraaua
赗	frao
沨	frau
浲	fraua
沣	frav
蜂	fria
峰	friaua
崶	friav
葑	frii
锋	frio
俸	friv
酆	friva
讽	froa
烽	frou
冯	frov
疯	frovua
唪	frovv
逢	frua
凤	fruaao
风	fruauo
封	frvo
堼	frvov
枫	frvu
砜	frvuu
奉	frvv
丰	frvvvi
溠	fsao
发	fsauao
渣	fsav
法	fsavoa
眨	fsia
罚	fsiaoa
蚱	fsiau
铡	fsio
扎	fsiu
挓	fsiuo
拃	fsiuu
揸	fsiuv
伐	fsiv
垡	fsivv
诈	fsoa
阀	fsoi
闸	fsoii
哳	fsoiu
咤	fsoo
怍	fsoou
咋	fsou
鲝	fsouu
炸	fsouuv
吒	fsouv
喳	fsov
痄	fsovu
猹	fsua
鲊	fsuau
齄	fsui
齇	fsuii
乏	fsuoao
乍	fsuv
筏	fsuvi
劄	fsuvii
轧	fsva
札	fsvaa
榨	fsvo
查	fsvoi
霅	fsvoo
砟	fsvuu
砝	fsvuv
䃎	fsvuvu
楂	fsvv
珐	fsvvv
赚	ftaoou
颛	ftia
僎	ftiaa
撰	ftiuav
传	ftiv
啭	ftovai
馔	ftua
篆	ftuvaa
砖	ftvu
瑑	ftvv
专	ftvvao
沸	fwaa
绯	fwaai
妃	fwau
淝	fwaua
飞	fwauoo
费	fwavao
菲	fwii
镄	fwio
斐	fwiv
翡	fwiva
蜚	fwivi
剕	fwivii
非	fwiviv
棐	fwivv
诽	fwoa
扉	fwoai
啡	fwoi
悱	fwoo
吠	fwov
废	fwovau
痱	fwovi
狒	fwua
鲱	fwuai
肥	fwuaiv
腓	fwui
朏	fwuo
肺	fwuv
篚	fwuvv
匪	fwvivv
霏	fwvo
榧	fwvv
终	fyaaua
忠	fyia
盅	fyiai
蚣	fyiau
中	fyiavi
仲	fyii
茽	fyiii
众	fyiiii
钟	fyio
锺	fyiou
冢	fyoa
踵	fyoi
忪	fyoo
衷	fyovia
螽	fyua
肿	fyui
舯	fyuu
重	fyuv
种	fyuvia
柊	fyvuao
沼	fzaa
罩	fzia
䓬	fzii
钊	fzio
招	fziuau
找	fziuva
诏	fzoa
肇	fzoaa
昭	fzoi
曌	fzoio
照	fzoioo
嘲	fzouo
旐	fzov
兆	fzuo
朝	fzuouu
笊	fzuv
赵	fzvouo
癸	gbaovv
妫	gbau
氿	gbaua
姽	gbauu
贵	gbia
刿	gbiai
嶲	gbiaio
眭	gbiav
傀	gbiu
归	gbiuav
刽	gbiv
郐	gbiva
诡	gboa
闺	gboi
炅	gboio
晷	gboiu
跪	gboiua
宄	gboo
炔	gbou
庋	gbov
廆	gbovu
龟	gbua
鲑	gbuav
鳜	gbuavu
皈	gbui
鬼	gbuiao
攰	gbuo
簋	gbuv
筀	gbuvv
轨	gbva
桧	gbvi
圭	gbvo
邽	gbvoa
硅	gbvu
柜	gbvv
匦	gbvva
规	gbvvia
桂	gbvvov
瑰	gbvvu
珪	gbvvv
鬶	gbvvvo
缑	gdaa
购	gdaoua
沟	gdau
姤	gdauu
媾	gdauv
岣	gdia
苟	gdii
钩	gdioua
佝	gdiu
拘	gdiuu
诟	gdoauu
勾	gdua
雊	gduai
句	gduao
够	gduaua
狗	gduaua
耇	gduo
篝	gduv
笱	gduvu
鞲	gdvi
垢	gdvo
彀	gdvou
枸	gdvu
构	gdvuaa
觏	gdvv
遘	gdvvo
纥	geaa
隔	geaivo
哿	geau
滆	geav
骼	geia
蛤	geiai
虼	geiau
个	geiii
葛	geiioi
铬	geio
镉	geiov
搁	geiu
搿	geiui
仡	geiuv
鸽	geiv
合	geivo
颌	geivv
袼	geoa
阁	geoi
割	geooii
咯	geou
盖	geoui
嗝	geov
疙	geovu
各	geuaoo
舸	geuu
胳	geuuao
膈	geuv
戈	geva
革	gevi
哥	gevo
鬲	gevoi
圪	gevou
歌	gevoua
塥	gevov
格	gevu
硌	gevuu
绀	gfaa
澉	gfaav
淦	gfai
㽏	gfaiv
泔	gfav
敢	gfavuv
苷	gfii
擀	gfiuuo
旰	gfoi
疳	gfov
咁	gfovi
赣	gfovua
鳡	gfua
乾	gfuo
竿	gfuv
秆	gfuvv
肝	gfuvvi
橄	gfva
甘	gfvi
酐	gfviv
赶	gfvo
坩	gfvov
尴	gfvu
感	gfvuoa
矸	gfvuv
杆	gfvv
柑	gfvvi
干	gfvvii
玕	gfvvv
夬	ggavuo
掴	ggiu
拐	ggiuoa
怪	ggooao
乖	gguviv
溉	ghaa
陔	ghai
赅	ghao
戤	ghau
改	ghavuv
芥	ghii
荄	ghiio
钙	ghiovi
该	ghoaov
晐	ghoi
概	ghvavv
丐	ghvi
垓	ghvo
孤	gjai
汩	gjao
沽	gjau
瀔	gjauo
姑	gjauuo
骨	gjia
蛊	gjiai
崮	gjiaia
蛄	gjiau
鹘	gjiaua
罟	gjiauo
固	gjiauo
菇	gjii
菰	gjiia
蓇	gjiii
锢	gjio
钴	gjiou
估	gjiu
诂	gjoa
雇	gjoaio
咕	gjou
呱	gjouu
羖	gjouua
痼	gjov
觚	gjua
鲴	gjuai
馉	gjuaia
谷	gjuo
嘏	gjuoa
辜	gjuoo
古	gjuooo
榖	gjuou
鸪	gjuoua
故	gjuouv
股	gjuu
𦙶	gjuuo
箍	gjuv
臌	gjuvo
牯	gjuvu
牿	gjuvuv
轱	gjva
贾	gjvi
酤	gjviu
鼓	gjvo
瞽	gjvoi
堌	gjvoia
毂	gjvou
梏	gjvu
顾	gjvuvu
涡	glaoia
果	glia
帼	gliai
蜾	gliaia
蝈	gliaia
崞	gliao
国	gliavv
锅	glio
呙	gloi
馘	glou
粿	gloui
裹	glov
郭	glovai
馃	glua
猓	gluaia
腘	glui
虢	gluo
过	glvioa
聒	glviuv
椁	glvo
埚	glvoo
洸	gmai
潢	gmavii
光	gmioua
咣	gmoi
广	gmovuu
犷	gmua
逛	gmuaoa
胱	gmui
𨐈	gmva
桄	gmviou
垙	gmvo
珖	gmvv
艮	gnavva
茛	gniiav
哏	gnoavv
跟	gnoiav
根	gnvavv
亘	gnvo
纲	gpaa
港	gpavii
岗	gpia
刚	gpiaii
冈	gpiau
罡	gpiav
钢	gpioia
扛	gpiu
冮	gpov
肛	gpuv
筻	gpuvv
缸	gpuvvi
㭎	gpvi
堽	gpvo
矼	gpvu
杠	gpvviv
括	gqiuuv
挂	gqiuvo
褂	gqoa
诖	gqoav
剐	gqoi
寡	gqoovu
瓜	gquu
胍	gquuu
鸹	gquv
刮	gquvii
坬	gqvo
卦	gqvoio
栝	gqvu
绠	graa
颈	graovu
浭	grav
羹	grou
哽	grov
赓	grova
庚	grovav
鹒	grovu
鲠	gruavi
耿	grvi
更	grviav
埂	grvo
梗	grvv
耕	grvvvv
尕	gsauiu
伽	gsiauo
钆	gsio
尜	gsiu
咖	gsoa
噶	gsoiio
嘎	gsovui
旮	gsuaoi
夹	gsvo
戛	gsvu
尬	gsvuiu
贯	gtaa
纶	gtaai
毌	gtaaiv
灌	gtai
涫	gtao
矜	gtaoi
观	gtaoia
莞	gtii
蒄	gtiio
鹳	gtiiua
倌	gtio
掼	gtiu
冠	gtoa
祼	gtoai
惯	gtoo
官	gtooia
爟	gtou
关	gtouvv
馆	gtua
鳏	gtuai
鳤	gtuau
盥	gtui
罐	gtuv
筦	gtuvo
管	gtuvoo
棺	gtvooa
瓘	gtvv
琯	gtvvo
绲	gwaa
给	gwaaiv
滚	gwaovu
衮	gwovuo
鲧	gwuaua
辊	gwva
棍	gwvoiv
磙	gwvu
红	gyaa
弓	gyavaa
拱	gyiu
供	gyivii
宫	gyoooo
唝	gyov
觥	gyua
躬	gyui
公	gyuoao
肱	gyuv
功	gyvi
贡	gyvia
汞	gyviaa
䢼	gyviai
恭	gyvii
攻	gyviu
巩	gyviua
共	gyviuo
工	gyvivv
龚	gyvu
廾	gyvui
珙	gyvv
栱	gyvvi
缟	gzaaov
藁	gzii
镐	gzio
锆	gziou
搞	gziuov
诰	gzoa
杲	gzoi
羔	gzou
糕	gzouou
膏	gzov
高	gzovia
睾	gzui
皋	gzuiv
稿	gzuv
郜	gzuva
篙	gzuvo
告	gzuvoo
筶	gzuvu
槁	gzvovo
槔	gzvu
绘	hbaa
缋	hbaai
洄	hbai
浍	hbaiv
贿	hbao
翚	hbaoo
汇	hbavaa
蛔	hbia
翙	hbiaa
睢	hbiai
回	hbiaoo
蟪	hbiav
荟	hbii
茴	hbiii
蕙	hbiiv
辉	hbio
挥	hbiu
会	hbivva
讳	hboa
喙	hboaa
诲	hboau
诙	hboav
袆	hboavv
晦	hboi
晖	hboio
悔	hboo
恢	hboovu
烩	hbou
烠	hbouv
麾	hbov
咴	hbovu
毁	hbuiua
卉	hbuo
徽	hbuu
秽	hbuv
惠	hbvi
恚	hbvo
虺	hbvu
灰	hbvuou
豗	hbvuvu
慧	hbvv
彗	hbvva
橞	hbvvi
珲	hbvvo
侯	hdia
骺	hdiau
候	hdiiav
吼	hdoa
喉	hdoiav
鲎	hdoo
糇	hdou
吽	hdouv
瘊	hdov
鲘	hdua
猴	hduaia
齁	hdui
逅	hduu
後	hduua
郈	hduuai
后	hduuoo
垕	hduuv
篌	hduv
堠	hdvo
厚	hdvuoi
涸	heai
渴	heao
翯	heaoo
贺	heau
河	heavoi
荷	heii
菏	heiia
盒	heiv
郃	heiva
何	heivoi
龁	heivu
龢	heivuv
壑	heivv
鹤	heoa
褐	heoao
诃	heoav
嗬	heoi
阂	heoio
曷	heoiu
鹖	heoiua
阖	heoiv
喝	heooiu
熇	heou
呵	heov
劾	heova
吓	heovi
饸	heua
貉	heuo
盉	heuv
禾	heuviu
和	heuvoo
鞨	hevi
赫	hevo
翮	hevoa
盍	hevoi
垎	hevou
核	hevova
涵	hfaa
汉	hfaaoo
函	hfai
浛	hfaio
瀚	hfau
憨	hfav
汗	hfavvi
蚶	hfia
崡	hfiaa
虷	hfiav
嵅	hfiavu
菡	hfii
蔊	hfiio
颔	hfio
含	hfiooo
撼	hfiu
撖	hfiua
捍	hfiuo
扞	hfiuv
罕	hfoa
旱	hfoi
阚	hfoia
晗	hfoii
暵	hfoiv
寒	hfoo
㘎	hfooi
悍	hfooo
憾	hfoov
焊	hfou
焓	hfoui
喊	hfovuv
犴	hfua
鼾	hfui
翰	hfuo
韩	hfuovv
邯	hfvi
酣	hfvivi
垾	hfvo
顸	hfvv
邗	hfvva
琀	hfvvi
淮	hgaiov
踝	hgoi
怀	hgoovu
徊	hguuia
坏	hgvovu
槐	hgvuia
骇	hhaa
孩	hhai
海	hhauva
骸	hhiaov
嗨	hhoa
咍	hhoao
咳	hhoo
嗐	hhooo
害	hhoovv
亥	hhov
胲	hhuo
氦	hhuvov
醢	hhvivu
还	hhvuoa
滹	hjai
沪	hjao
浒	hjaoa
淴	hjau
嫭	hjaui
湖	hjauoo
弧	hjav
蝴	hjia
囫	hjiaua
岵	hjiauo
葫	hjii
芴	hjiiu
护	hjiuoa
虎	hjiv
虍	hjivv
扈	hjoa
戽	hjoao
祜	hjoau
隺	hjoaui
许	hjoauv
户	hjoavu
唬	hjoi
昈	hjoio
昒	hjoiu
惚	hjoo
怙	hjoou
呼	hjou
唿	hjoua
糊	hjouu
烀	hjouuo
煳	hjouuo
冱	hjov
忽	hjua
鹱	hjuai
鳠	hjuaii
斛	hjuao
狐	hjuau
猢	hjuauo
鹕	hjuo
胡	hjuouu
乎	hjuouv
鹄	hjuvu
笏	hjuvua
轷	hjva
互	hjvaav
醐	hjvi
壶	hjvo
鄠	hjvoa
縠	hjvou
觳	hjvoua
槲	hjvu
瓠	hjvuu
瑚	hjvv
琥	hjvvi
濩	hlai
漷	hlao
活	hlauvi
彟	hlav
夥	hlia
蠖	hliai
藿	hlii
劐	hliii
获	hliiua
伙	hlio
镬	hlioi
钬	hlioo
锪	hliou
货	hliu
攉	hliuv
佸	hliuvi
祸	hloa
嚄	hloi
豁	hloo
㸌	hlou
火	hlouii
嚯	hlov
惑	hlvo
霍	hlvoio
或	hlvova
耠	hlvv
隍	hmaiui
滉	hmao
湟	hmau
媓	hmauu
幌	hmia
蝗	hmiau
蟥	hmiav
荒	hmiiov
锽	hmio
𨱑	hmioi
谎	hmoa
晃	hmoi
惶	hmoo
恍	hmooi
慌	hmooii
噷	hmoov
煌	hmou
喤	hmoui
肓	hmov
癀	hmovv
凰	hmua
鳇	hmuau
遑	hmui
㿠	hmuii
皇	hmuivv
徨	hmuu
艎	hmuuu
簧	hmuv
篁	hmuvu
黄	hmviia
磺	hmvuvi
璜	hmvv
瑝	hmvvu
恨	hnooav
痕	hnov
狠	hnuaav
很	hnuuav
绗	hpaa
沆	hpaovu
吭	hpoovu
颃	hpov
航	hpuuov
行	hpuuvv
巷	hpvi
杭	hpvovu
夯	hpvu
桁	hpvuu
珩	hpvv
骅	hqaa
滑	hqaiaa
婳	hqau
花	hqii
铧	hqio
华	hqiu
化	hqiuaa
话	hqoauv
哗	hqoiua
觟	hqua
猾	hquaia
划	hqvaii
画	hqvi
桦	hqviu
砉	hqvv
姮	hrauvo
蘅	hriiuu
恒	hroo
哼	hroovo
亨	hrov
鸻	hruu
衡	hruuua
横	hrvvii
虾	hsia
铪	hsio
哈	hsoivo
幻	htaa
缳	htaai
缓	htaauo
漶	htai
澴	htaia
欢	htao
浣	htaoo
涣	htau
嬛	htaui
洹	htav
圜	htia
患	htiaoa
鹮	htiau
峘	htiav
萑	htii
荁	htiiv
锾	htio
镮	htioi
擐	htiu
换	htiuua
㬊	htoi
宦	htoo
寰	htooi
逭	htooo
焕	htou
唤	htouai
豢	htouv
痪	htov
獾	htua
郇	htuaa
奂	htuaia
鲩	htuao
貆	htuo
鬟	htvi
垸	htvo
环	htvv
桓	htvvo
𤩽	htvvu
溷	hwai
浑	hwao
混	hwaoiv
婚	hwau
婫	hwauo
黑	hwiaoo
荤	hwiiva
诨	hwoa
阍	hwoi
嘿	hwoiao
惛	hwoo
馄	hwua
昏	hwuaoi
魂	hwvvui
泓	hyaa
纮	hyaav
鸿	hyav
弘	hyava
洪	hyavii
虹	hyiavi
薨	hyii
荭	hyiia
蕻	hyiiv
讧	hyoa
闳	hyoi
黉	hyoo
宏	hyoovu
烘	hyou
哄	hyov
竑	hyovv
訇	hyuaov
谼	hyuo
轰	hyvaao
翃	hyvu
硔	hyvuv
玒	hyvv
濠	hzao
灏	hzaoi
淏	hzaoiv
好	hzauai
浩	hzauvi
蚝	hzia
薅	hzii
蒿	hziiov
侴	hziv
昊	hzoi
嚆	hzoii
颢	hzoiv
嚎	hzoo
嗥	hzou
毫	hzov
鄗	hzova
号	hzovaa
豪	hzovv
皞	hzui
皓	hzuiuv
郝	hzvo
壕	hzvoo
耗	hzvvuv
浸	jbaa
津	jbaav
缙	jbaavi
浕	jbaavu
卺	jbai
劲	jbao
赆	jbaoa
妗	jbau
溍	jbav
尽	jbavoo
仅	jbia
巾	jbiai
紧	jbii
荩	jbiia
今	jbio
金	jbioo
锦	jbiou
搢	jbiu
襟	jboa
祲	jboaa
衿	jboai
谨	jboavi
烬	jbou
噤	jbov
廑	jbovv
馑	jbua
斤	jbuu
近	jbuuoa
筋	jbuv
晋	jbvi
觐	jbvii
堇	jbviia
靳	jbviu
墐	jbvo
殣	jbvu
瑾	jbvv
珒	jbvva
槿	jbvvi
进	jbvvoa
琎	jbvvv
瑨	jbvvvi
禁	jbvvvv
骄	jcaa
剿	jcaai
糸	jcaaiu
绞	jcaao
滘	jcao
娇	jcau
姣	jcauo
漖	jcauov
湫	jcauv
浇	jcav
蛟	jcia
峧	jciao
峤	jciau
蕉	jcii
茭	jciio
藠	jciioi
斠	jciioo
僬	jciiov
艽	jciiu
佼	jcio
铰	jcioo
焦	jciooo
鹪	jciou
搅	jciu
挢	jciuu
侥	jciv
叫	jcoaii
跤	jcoi
噍	jcoio
觉	jcoo
窖	jcoou
嚼	jcou
燋	jcoui
郊	jcov
䴔	jcovu
交	jcovuo
角	jcua
饺	jcuao
狡	jcuaov
鲛	jcuaov
皎	jcui
敫	jcuiu
皦	jcuiui
皭	jcuiuo
胶	jcuo
教	jcuouv
徼	jcuu
脚	jcuv
矫	jcuvu
轿	jcva
较	jcvaov
椒	jcvi
醮	jcvii
酵	jcviu
校	jcvo
礁	jcvu
璬	jcvv
结	jdaa
阶	jdai
岊	jdaii
孑	jdaiv
婕	jdau
姐	jdauia
洁	jdav
湝	jdava
届	jdavi
界	jdia
蚧	jdiai
骱	jdiaiu
睫	jdiav
蜐	jdiavo
藉	jdii
节	jdiiai
价	jdiiu
偈	jdio
介	jdiu
揭	jdiuo
接	jdiuov
捷	jdiuv
拮	jdiuvo
借	jdiv
诫	jdoa
褯	jdoao
诘	jdoav
讦	jdoavv
嗟	jdoo
悈	jdoov
羯	jdou
疥	jdov
疖	jdova
喈	jdovau
竭	jdovoi
桀	jdua
解	jduaau
鲒	jduav
截	jduo
劼	jduoa
街	jduu
秸	jduv
皆	jdva
劫	jdvo
杰	jdvooo
颉	jdvov
檞	jdvu
碣	jdvuo
戒	jdvv
楷	jdvva
㛃	jdvvau
玠	jdvvi
桔	jdvvo
澈	jeaova
尺	jeav
扯	jeiu
撤	jeiuov
㬚	jeoiov
彻	jeuuva
掣	jeuv
车	jevavi
坼	jevouu
砗	jevu
潺	jfaa
骣	jfaaa
缠	jfaaov
澶	jfao
浐	jfaov
瀍	jfaovu
婵	jfau
羼	jfavo
蝉	jfia
辿	jfiao
蟾	jfiau
巉	jfiaua
蒇	jfii
铲	jfio
儳	jfioa
镵	jfiou
镡	jfiov
搀	jfiu
觇	jfiv
谄	jfoa
谗	jfoau
襜	jfoaua
阐	jfoi
旵	jfoii
躔	jfoio
忏	jfoo
冁	jfoua
廛	jfov
产	jfovou
馋	jfuaua
韂	jfvi
梴	jfvu
刬	jfvvii
泾	jgaa
经	jgaaao
阱	jgai
刭	jgaoi
迳	jgaoo
婧	jgau
弪	jgav
汫	jgavv
睛	jgia
敬	jgii
茎	jgiia
荆	jgiii
儆	jgiiiu
警	jgiiov
菁	jgiiv
镜	jgio
景	jgoi
晶	jgoio
惊	jgoo
憬	jgooo
精	jgou
粳	jgouv
京	jgov
痉	jgova
竞	jgovo
麖	jgovov
净	jgovu
竫	jgovua
竟	jgovua
旌	jgovuv
靖	jgovv
鲸	jgua
胫	jguao
猄	jguaov
獍	jguaov
鼱	jgui
兢	jguo
𠳬	jguou
径	jguuao
箐	jguv
腈	jguvv
肼	jguvvu
境	jgvo
井	jgvv
靓	jgvvi
璥	jgvvii
璟	jgvvo
䴖	jgvvu
静	jgvvua
绝	jhaaua
孓	jhai
㵐	jhav
倔	jhia
崛	jhiaa
𨟠	jhiaai
矍	jhiai
蕨	jhii
茝	jhiiv
钗	jhio
傕	jhioa
鐍	jhioao
镢	jhiov
侪	jhiovu
掘	jhiu
抉	jhiua
攫	jhiui
撅	jhiuv
柴	jhiv
诀	jhoa
谲	jhoaa
蹶	jhoi
噱	jhoiv
爝	jhouu
噘	jhov
决	jhovav
獗	jhua
觖	jhuaa
玃	jhuai
爵	jhuo
豺	jhuov
虿	jhva
桷	jhvu
砄	jhvua
劂	jhvui
厥	jhvuou
橛	jhvv
玦	jhvva
珏	jhvvv
绌	jjaa
滁	jjaai
䢺	jjai
出	jjaiia
除	jjaiiv
濋	jjav
黜	jjia
蜍	jjiai
俶	jjii
锄	jjio
储	jjioau
搐	jjiu
摴	jjiuv
初	jjoaau
躇	jjoi
蹰	jjoiv
怵	jjoo
㤘	jjoou
憷	jjoov
畜	jjov
触	jjua
刍	jjuaa
雏	jjuai
处	jjuaio
矗	jjuo
䝙	jjuov
斶	jjuu
础	jjvu
楮	jjvuo
杵	jjvuv
厨	jjvuvo
楚	jjvv
亍	jjvvi
樗	jjvvo
橱	jjvvu
级	jkaa
纪	jkaaa
骥	jkaai
畿	jkaaia
继	jkaao
缉	jkaaov
绩	jkaav
骑	jkaavu
际	jkai
瀱	jkaia
亟	jkaio
济	jkao
鸡	jkaou
激	jkau
汲	jkaua
漈	jkauao
洎	jkaui
嫉	jkauo
妓	jkauu
姞	jkauuo
姬	jkauv
己	jkav
即	jkavai
忌	jkavo
暨	jkavoi
屐	jkavu
彐	jkavv
既	jkavva
堲	jkavvo
畸	jkia
觊	jkiai
嵴	jkiao
岌	jkiau
虮	jkiaua
羁	jkiav
罽	jkiavu
蒺	jkiio
荠	jkiiov
蕺	jkiiov
蓟	jkiiu
芨	jkiiua
芰	jkiiuo
䓫	jkiiv
集	jkio
挤	jkiu
伋	jkiua
技	jkiuuo
掎	jkiuv
冀	jkiv
乩	jkiva
佶	jkivo
计	jkoa
记	jkoaav
讥	jkoau
唧	jkoavv
跻	jkoi
跽	jkoia
蹐	jkoiu
寄	jkoo
寂	jkooi
悸	jkoou
哜	jkoov
叽	jkou
疾	jkov
剂	jkovi
齑	jkoviv
迹	jkovo
咭	jkovoo
瘠	jkovov
脊	jkovu
麂	jkovua
鹡	jkovua
及	jkua
鲫	jkuaa
几	jkuaaa
鱾	jkuaav
系	jkuai
急	jkuao
鲚	jkuaov
饥	jkuau
觭	jkuavu
戟	jkuo
赍	jkuoa
肌	jkuu
徛	jkuuv
积	jkuv
季	jkuva
稷	jkuvi
笈	jkuvu
穄	jkuvua
籍	jkuvv
箕	jkuvvi
嵇	jkuvvu
犄	jkuvvu
稽	jkuvvu
笄	jkuvvv
辑	jkva
基	jkvi
惎	jkvio
期	jkviu
其	jkviuo
棘	jkviv
墼	jkvivo
髻	jkvivo
吉	jkvo
霁	jkvoo
圾	jkvou
垍	jkvoui
楫	jkvov
极	jkvu
殛	jkvua
机	jkvuaa
剞	jkvui
丌	jkvuii
矶	jkvuu
奇	jkvuv
击	jkvv
玑	jkvvu
枅	jkvvv
耤	jkvvvi
驹	jlaa
沮	jlai
澽	jlaiv
泃	jlau
娵	jlauv
剧	jlav
局	jlavao
屦	jlavu
居	jlavuo
具	jlia
崌	jliaa
雎	jliai
岨	jliaia
瞿	jliaio
䴗	jliau
倨	jliav
岠	jliava
且	jliavv
俱	jlii
苴	jliii
莒	jliio
蒟	jliiov
菊	jliiu
苣	jliiv
锯	jlio
锔	jlioa
钜	jliov
拒	jliu
据	jliuav
掬	jliuua
遽	jliv
龃	jlivi
讵	jloa
裾	jloaa
距	jloi
踞	jloia
咀	jloiav
踽	jloiu
惧	jloo
窭	jlooo
举	jloovv
炬	jlou
焗	jloua
疽	jlov
狙	jlua
飓	jluai
腒	jluav
矩	jluv
犋	jluvi
筥	jluvo
榘	jluvv
秬	jluvva
橘	jlva
巨	jlvava
椐	jlvavu
聚	jlvi
醵	jlvii
鞠	jlviu
鞫	jlviua
榉	jlvo
趄	jlvoi
弆	jlvov
砠	jlvui
琚	jlvva
溅	jmaa
缣	jmaao
缄	jmaav
艰	jmao
涧	jmaoi
湔	jmaou
贱	jmaov
奸	jmau
渐	jmav
建	jmavao
健	jmia
囝	jmiaa
睑	jmiai
见	jmiaua
坚	jmii
监	jmiii
茧	jmiiia
鉴	jmiiio
菅	jmiio
蒹	jmiiou
荐	jmiiv
俭	jmiivo
键	jmio
锏	jmioo
件	jmiu
捡	jmiui
搛	jmiuo
尖	jmiuv
拣	jmiuva
剑	jmiv
僭	jmiva
牮	jmivu
肩	jmoa
裥	jmoao
谫	jmoaou
谏	jmoav
践	jmoi
踺	jmoia
间	jmoioi
趼	jmoiv
暕	jmoivi
謇	jmoo
蹇	jmooo
兼	jmou
剪	jmoua
翦	jmouao
煎	jmouo
鹣	jmouu
减	jmovvu
饯	jmua
鲣	jmuai
鳒	jmuao
腱	jmuav
舰	jmuu
箭	jmuv
毽	jmuva
犍	jmuvav
笕	jmuvi
篯	jmuvio
简	jmuvoi
笺	jmuvv
楗	jmva
靬	jmvav
柬	jmvi
枧	jmvia
鞬	jmviav
槛	jmvii
鞯	jmviii
戬	jmviv
检	jmvivo
歼	jmvu
硷	jmvui
碱	jmvuv
戋	jmvv
陈	jnaiva
沉	jnaoau
瞋	jnia
抻	jniu
尘	jniuvo
龀	jniv
衬	jnoa
谶	jnoai
晨	jnoivu
忱	jnoo
宸	jnoov
嗔	jnou
煁	jnouv
疢	jnov
称	jnuvua
梣	jnvi
臣	jnviav
趁	jnvo
榇	jnvov
辰	jnvu
碜	jnvua
琛	jnvv
郴	jnvva
棽	jnvvi
淌	jpai
嫦	jpau
娼	jpauoi
畅	jpia
偿	jpii
菖	jpiio
苌	jpiiu
尝	jpio
倡	jpioi
常	jpioia
敞	jpiou
氅	jpiouv
伥	jpiu
昶	jpoa
昌	jpoi
阊	jpoio
怅	jpoo
惝	jpooi
唱	jpooio
猖	jpua
鲿	jpuai
鲳	jpuao
肠	jpuauu
鬯	jpuo
徜	jpuu
长	jpuvao
场	jpvoau
厂	jpvu
玚	jpvv
纠	jqaa
酒	jqavia
㠇	jqia
僦	jqio
旧	jqioii
揪	jqiu
韭	jqiv
阄	jqoi
究	jqooua
啾	jqou
疚	jqov
鹫	jqovu
就	jqovvu
灸	jqua
九	jquaa
咎	jquao
久	jquaoo
鸠	jquau
舅	jqui
臼	jquiv
鬏	jqvi
救	jqviuv
赳	jqvo
厩	jqvu
桕	jqvui
玖	jqvv
柩	jqvvu
骋	jraai
丞	jrai
澂	jraia
承	jraivv
瞠	jria
蛏	jriaa
峸	jriav
铖	jrio
牚	jriov
抢	jriu
撑	jriuio
偁	jriuo
诚	jroa
裎	jroao
宬	jroo
憕	jrooa
逞	jrov
庱	jrovv
呈	jrovvi
塍	jruo
惩	jruu
程	jruv
秤	jruvv
橙	jrva
柽	jrvao
酲	jrvi
埕	jrvo
赪	jrvoi
城	jrvovu
成	jrvuaa
枨	jrvuv
琤	jrvv
珵	jrvvo
珹	jrvvv
泇	jsaa
驾	jsau
嫁	jsauo
迦	jsauoa
加	jsauoo
袈	jsauov
架	jsauvv
浃	jsav
叚	jsavi
甲	jsia
岬	jsiai
蛱	jsiav
假	jsiavi
茄	jsiia
葭	jsiiav
荚	jsiiv
钾	jsio
镓	jsioo
铗	jsiov
挟	jsiu
佳	jsiv
袷	jsoai
跏	jsoi
斝	jsoo
家	jsoovu
痂	jsov
瘕	jsova
胛	jsuiav
稼	jsuv
笳	jsuva
枷	jsva
嘉	jsvo
郏	jsvoa
颊	jsvov
珈	jsvv
槚	jsvvi
恝	jsvvo
绢	jtaaou
涓	jtao
娟	jtau
圈	jtia
倦	jtio
隽	jtioa
镌	jtioi
锩	jtioo
捐	jtiuou
鹃	jtou
卷	jtouaa
蠲	jtoui
眷	jtouia
焆	jtouo
桊	jtouv
狷	jtuaou
鄄	jtviai
骏	jwaa
浚	jwaao
纯	jwaava
淳	jwao
君	jwav
郡	jwava
峻	jwia
畯	jwiaa
俊	jwiaou
蝽	jwiav
菌	jwii
莼	jwiia
莙	jwiiav
葰	jwiii
钧	jwio
捃	jwiu
皲	jwoa
军	jwoava
晙	jwoi
竣	jwov
鹑	jwovu
麇	jwovuv
鲪	jwua
䲠	jwuav
朐	jwuu
筠	jwuv
肫	jwuva
䏝	jwuvv
醇	jwvi
均	jwvoua
唇	jwvu
蠢	jwvv
珺	jwvva
春	jwvvoi
椿	jwvvv
瑃	jwvvvv
缰	jxaa
绛	jxaau
降	jxai
洚	jxau
疆	jxav
弜	jxava
江	jxaviv
强	jxavo
弶	jxavov
犟	jxavu
茳	jxii
蒋	jxiiov
僵	jxiv
讲	jxoavv
姜	jxou
糨	jxoua
奖	jxov
浆	jxova
将	jxovua
桨	jxovv
酱	jxovvi
膙	jxua
鳉	jxuaov
豇	jxvo
礓	jxvu
匠	jxvuuv
耩	jxvv
䌹	jyaa
泂	jyaiao
冏	jyia
迥	jyiaoa
囧	jyiauo
扃	jyoa
窘	jyooav
炯	jyou
颎	jyuavu
䐃	jyui
坰	jyvoia
巢	jzaa
绰	jzaai
潮	jzauoo
弨	jzav
钞	jzio
抄	jziuiu
吵	jzoi
晁	jzoiu
怊	jzoo
炒	jzouiu
超	jzvoau
耖	jzvviu
骙	kbaa
隗	kbai
溃	kbaiav
戣	kbao
睽	kbia
岿	kbiai
蝰	kbiav
蒉	kbii
葵	kbiiao
揆	kbiua
喟	kboi
暌	kboia
跬	kboiv
窥	kboo
愦	kbooi
悝	kbooia
愧	kbooui
夔	kbou
煃	kbouv
喹	kbov
馈	kbua
馗	kbuao
魁	kbuioo
篑	kbuv
匮	kbvi
聩	kbvii
逵	kbvo
盔	kbvu
櫆	kbvui
奎	kbvuvo
亏	kbvvaa
眍	kdia
蔻	kdii
芤	kdiia
抠	kdiu
扣	kdiuoo
叩	kdoaii
口	kdoo
寇	kdoov
筘	kduviu
缂	keaa
骒	keaai
牁	keai
溘	keav
瞌	keia
髁	keiai
蝌	keiau
岢	keiav
蚵	keiavo
颗	keiavu
苛	keii
锞	keio
钶	keiov
课	keoa
窠	keooi
喀	keooo
恪	keoou
客	keooua
炣	keou
刻	keov
嗑	keovo
颏	keovv
疴	keovvo
尅	keuo
克	keuoou
稞	keuv
科	keuvoo
氪	keuvu
轲	keva
棵	kevi
匼	keviv
坷	kevo
可	kevoii
壳	kevoua
磕	kevu
柯	kevv
珂	kevvv
瞰	kfia
崁	kfiav
嵁	kfiavi
莰	kfii
侃	kfioui
看	kfiuia
龛	kfiv
衎	kfuivv
勘	kfvi
戡	kfviv
坎	kfvo
墈	kfvov
堪	kfvovi
砍	kfvu
磡	kfvuv
刊	kfvv
侩	kgii
蒯	kgiii
㧟	kgiu
哙	kgoivv
快	kgooav
狯	kgua
鲙	kguai
脍	kgui
筷	kguvoo
块	kgvoav
剀	khia
凯	khiaua
蒈	khii
铠	khio
锎	khioo
锴	khiov
揩	khiu
闿	khoi
忾	khoo
慨	khooav
恺	khooi
炌	khou
垲	khvo
开	khvvui
绔	kjaavu
骷	kjia
圐	kjiai
苦	kjiiuo
裤	kjoa
袴	kjoav
窟	kjoo
喾	kjoou
哭	kjoovu
库	kjovva
酷	kjviuv
堀	kjvo
枯	kjvu
刳	kjvui
矻	kjvuu
蛞	klia
扩	kliuov
阔	kloiau
廓	klov
纩	kmaaov
贶	kmao
洭	kmav
眶	kmiavv
诳	kmoa
诓	kmoav
旷	kmoiov
邝	kmov
况	kmovou
哐	kmovv
狂	kmuavv
筐	kmuv
圹	kmvo
矿	kmvu
夼	kmvuu
匡	kmvv
框	kmvvvv
垦	knav
恳	knavoa
龈	knivav
肯	knivuu
裉	knoa
啃	knoivi
硍	knvuav
伉	kpio
钪	kpioo
抗	kpiuov
闶	kpoi
慷	kpoo
糠	kpou
炕	kpouo
亢	kpov
康	kpovav
𩾌	kpuaov
𡐓	kpvoov
姱	kqauvu
挎	kqiuvu
侉	kqiv
跨	kqoivu
胯	kquvuo
垮	kqvovu
夸	kqvuvv
铿	krioii
坑	krvoov
硁	krvuao
佧	ksiivv
卡	ksivvi
咔	ksoi
胩	ksuivv
髋	ktiaoo
宽	ktooii
款	ktvoua
困	kwiavv
锟	kwio
捆	kwiuia
裈	kwoa
阃	kwoi
鹍	kwoiu
昆	kwoiva
悃	kwoo
焜	kwou
堃	kwov
鲲	kwuaoi
剋	kwuo
髡	kwvi
醌	kwvio
壸	kwvo
坤	kwvoia
琨	kwvv
孔	kyaiaa
崆	kyia
倥	kyio
控	kyiuoo
空	kyoovi
箜	kyuvoo
恐	kyvioa
埪	kyvo
硿	kyvu
洘	kzau
尻	kzavua
铐	kzio
拷	kziuuo
㸆	kzou
烤	kzouuo
考	kzuova
犒	kzuv
靠	kzuviv
栲	kzvuov
潾	lbao
淋	lbavvv
嶙	lbia
瞵	lbiao
蔺	lbii
临	lbiiuv
邻	lbio
拎	lbiu
赁	lbiua
躏	lboi
懔	lboo
粼	lbou
翷	lboua
遴	lbouo
燐	lbouou
凛	lbov
吝	lbovo
麟	lbovou
廪	lbovov
啉	lbovv
鳞	lbuaou
膦	lbuo
箖	lbuv
辚	lbva
霖	lbvo
檩	lbvov
磷	lbvu
璘	lbvv
林	lbvvv
琳	lbvvvv
缭	lcaa
漻	lcaao
了	lcaii
辽	lcaioa
嫽	lcau
潦	lcav
瞭	lcia
髎	lciaa
蓼	lcii
镣	lcio
钌	lcioa
撩	lciu
撂	lciui
僚	lcivuo
蹽	lcoi
寥	lcoo
寮	lcoov
憭	lcoovu
燎	lcou
料	lcouoo
疗	lcov
廖	lcova
嘹	lcovu
獠	lcuavu
簝	lcuv
聊	lcviua
鹩	lcvu
尥	lcvuua
橑	lcvv
漏	ldaavu
陋	ldai
溇	ldao
洌	ldav
髅	ldia
蝼	ldiao
嵝	ldiaou
䁖	ldiaou
蒌	ldii
镂	ldio
偻	ldiou
劣	ldiu
捩	ldiuo
搂	ldiuou
躐	ldoi
喽	ldoo
娄	ldou
冽	ldov
瘘	ldovo
咧	ldovua
猎	lduavi
脟	lduu
篓	lduv
鬣	ldvi
露	ldvo
剅	ldvoi
埒	ldvou
楼	ldvouv
趔	ldvov
裂	ldvu
列	ldvuii
烈	ldvuo
䴕	ldvuu
耧	ldvv
泐	leaaia
仂	leiauu
叻	leoa
嘞	leovii
饹	leua
乐	leuaiu
肋	leuauu
鳓	leuav
簕	leuv
勒	leviau
砳	levu
缆	lfaa
滥	lfaiiu
澜	lfao
漤	lfav
岚	lfia
罱	lfiau
览	lfii
蓝	lfiiii
镧	lfio
拦	lfiu
揽	lfiui
褴	lfoa
谰	lfoao
襕	lfoaoi
阑	lfoi
懒	lfoo
烂	lfouou
兰	lfouvv
斓	lfov
篮	lfuvii
榄	lfvi
栏	lfvouv
婪	lfvv
绫	lgaa
陵	lgai
泠	lgaio
姈	lgau
澪	lgav
灵	lgavou
岭	lgia
蛉	lgiai
囹	lgiaio
崚	lgiav
菱	lgii
苓	lgiii
伶	lgiio
铃	lgio
翎	lgioa
令	lgioao
鸰	lgiou
瓴	lgiov
领	lgiovu
龄	lgiv
祾	lgoa
另	lgoauu
呤	lgoi
昤	lgoii
〇	lgoo
㥄	lgoov
羚	lgou
凌	lgov
鲮	lguavo
舲	lguu
棂	lgva
聆	lgvi
柃	lgvio
酃	lgvo
坽	lgvoi
零	lgvoio
玲	lgvv
棱	lgvvo
涞	lhav
濑	lhavia
睐	lhia
圙	lhiau
略	lhiaua
崃	lhiav
莱	lhii
锊	lhio
铼	lhiov
掠	lhiu
俫	lhivo
癞	lhovvi
徕	lhuu
籁	lhuvvi
赖	lhviua
赉	lhvo
来	lhvouv
梾	lhvv
䂮	lhvvv
绿	ljaa
渌	ljaav
泸	ljai
陆	ljaivv
赂	ljao
勠	ljaoa
潞	ljaoi
戮	ljaov
漉	ljaovu
澛	ljau
录	ljav
逯	ljavo
僇	ljia
芦	ljii
菉	ljiiav
蕗	ljiio
镥	ljio
撸	ljiu
掳	ljiui
虏	ljiv
卢	ljivav
卤	ljivi
鸬	ljivu
颅	ljivv
禄	ljoa
鹭	ljoi
路	ljoiua
噜	ljou
炉	ljouoa
鹿	ljov
庐	ljovo
六	ljovu
鲈	ljua
鲁	ljuaoi
胪	ljui
舻	ljuu
甪	ljuua
氇	ljuv
箓	ljuva
簏	ljuvo
稑	ljuvv
辘	ljva
轳	ljvai
辂	ljvau
栌	ljvi
垆	ljvo
碌	ljvu
橹	ljvua
麓	ljvv
琭	ljvva
璐	ljvvo
蠡	lkaa
缡	lkaao
骊	lkaav
澧	lkai
浬	lkaia
漓	lkao
娌	lkau
力	lkauu
浰	lkauv
隶	lkav
溧	lkavi
沥	lkavu
罹	lkia
詈	lkiao
蜊	lkiau
蛎	lkiav
峛	lkiavu
里	lkiavv
莉	lkii
荔	lkiia
俚	lkiiav
莅	lkiii
蓠	lkiio
藜	lkiiu
苈	lkiiv
锂	lkio
俐	lkiu
俪	lkiv
傈	lkivi
例	lkivua
礼	lkoa
戾	lkoav
哩	lkoi
跞	lkoiu
唳	lkoo
粒	lkou
粝	lkouv
离	lkov
立	lkovou
痢	lkovu
呖	lkovua
喱	lkovui
疠	lkovv
凓	lkovvi
疬	lkovvu
狸	lkua
鲤	lkuai
鳢	lkuaia
猁	lkuau
鲡	lkuav
梨	lkuv
黎	lkuvi
黧	lkuvia
利	lkuvii
篱	lkuvo
笠	lkuvov
犁	lkuvu
篥	lkuvv
李	lkva
轹	lkvau
朸	lkvauu
丽	lkvi
吏	lkvia
醴	lkvii
逦	lkvio
醨	lkviov
鹂	lkviu
栗	lkviv
雳	lkvo
坜	lkvov
历	lkvu
励	lkvua
栎	lkvuai
厘	lkvui
砬	lkvuo
砾	lkvuu
厉	lkvuv
㰀	lkvuvi
砺	lkvuvu
璃	lkvv
珕	lkvva
理	lkvvia
枥	lkvvu
嫠	lkvvv
釐	lkvvvu
驴	llaa
骡	llaai
缕	llaao
络	llaau
骆	llaaua
滤	llai
漯	llaia
洛	llau
泺	llaua
屡	llav
履	llavu
逻	llia
螺	lliai
罗	lliaua
萝	llii
倮	lliia
落	lliiau
荦	lliiu
葎	lliiuu
蓏	lliiuu
侣	llio
锣	llioi
镙	llioia
铝	llioo
捋	lliu
摞	lliui
虑	lliv
裸	lloa
褛	lloao
啰	lloi
闾	lloio
吕	lloo
烙	llouu
旅	llov
瘰	llovi
蠃	llovo
膂	llovu
猡	llua
雒	lluai
脶	lluo
𦝼	lluou
律	lluuav
箩	lluv
氯	lluva
稆	lluvo
椤	llvi
垏	llvo
榈	llvoia
梠	llvoo
珞	llvv
练	lmaava
潋	lmai
濂	lmao
涟	lmav
蠊	lmia
莶	lmii
蔹	lmiii
莲	lmiiva
链	lmio
镰	lmioo
敛	lmiv
裢	lmoa
裣	lmoai
怜	lmoo
帘	lmooi
炼	lmou
廉	lmov
恋	lmovoa
鲢	lmua
脸	lmuivo
臁	lmuo
连	lmvaoa
联	lmviou
殓	lmvu
磏	lmvuo
奁	lmvuv
琏	lmvv
梿	lmvva
楝	lmvvi
瑓	lmvvv
浪	lpaoav
崀	lpia
螂	lpiaoa
莨	lpii
蒗	lpiia
蓢	lpiio
锒	lpio
郎	lpoa
朗	lpoauu
塱	lpoav
㮾	lpoavv
阆	lpoi
㫰	lpoio
啷	lpoo
烺	lpou
廊	lpov
狼	lpuaoa
稂	lpuv
筤	lpuvo
榔	lpvo
桹	lpvoa
埌	lpvoo
琅	lpvvoa
绺	lqaa
骝	lqaau
浏	lqao
鎏	lqaoi
鹨	lqaou
瑬	lqaov
流	lqaova
溜	lqau
疁	lqia
罶	lqiau
锍	lqio
镠	lqioa
镏	lqioua
熘	lqou
瘤	lqov
刘	lqovii
旒	lqovu
遛	lqua
留	lquaia
馏	lquau
飗	lquaua
鹠	lquaua
硫	lqvu
榴	lqvua
柳	lqvuau
琉	lqvv
珋	lqvvu
愣	lrooia
冷	lrovio
楞	lrvi
塄	lrvo
堎	lrvov
邋	lsaaoa
蜡	lsia
蝲	lsiav
菈	lsiii
镴	lsio
拉	lsiuov
俩	lsivia
旯	lsoi
啦	lsoiuo
辣	lsov
喇	lsovi
瘌	lsovv
腊	lsuvii
剌	lsvi
鞡	lsvii
垃	lsvoov
滦	ltaovi
孪	ltov
娈	ltova
銮	ltovi
脔	ltovia
峦	ltovia
挛	ltoviu
鸾	ltovu
栾	ltovv
卵	ltuaai
乱	ltuvaa
缧	lwaai
沦	lwai
泪	lwaiav
垒	lwao
嫘	lwau
囵	lwia
累	lwiaaa
罍	lwiau
伦	lwii
儡	lwiia
藟	lwiii
蕾	lwiiv
镭	lwio
仑	lwiu
抡	lwiui
擂	lwiuv
诔	lwoa
论	lwoaiu
类	lwouvu
羸	lwov
癗	lwovv
轮	lwvaiu
酹	lwviu
雷	lwvo
磊	lwvu
礌	lwvuv
耒	lwvv
檑	lwvvo
粱	lxaa
梁	lxaavv
俍	lxio
倞	lxiov
良	lxoa
谅	lxoao
晾	lxoi
量	lxoiia
踉	lxoio
悢	lxoo
粮	lxou
亮	lxov
凉	lxovo
魉	lxuivi
辌	lxva
辆	lxvavi
两	lxviau
椋	lxvo
墚	lxvoa
漋	lyaa
陇	lyai
隆	lyaiua
眬	lyia
茏	lyii
拢	lyiuvu
昽	lyoi
窿	lyoo
癃	lyov
咙	lyovua
哢	lyovv
胧	lyuv
笼	lyuvvu
垅	lyvo
聋	lyvu
尨	lyvua
龙	lyvuau
砻	lyvuv
垄	lyvuvo
弄	lyvv
栊	lyvvu
珑	lyvvv
涝	lzai
嫪	lzau
姥	lzauuo
崂	lzia
劳	lziiau
荖	lziiu
铑	lzio
铹	lzioi
捞	lziu
佬	lziuo
唠	lzoi
牢	lzoouv
痨	lzov
老	lzuoua
醪	lzvi
酪	lzviua
栳	lzvu
耢	lzvv
缗	mbaa
湣	mbaav
泯	mbaava
愍	mbav
民	mbavav
岷	mbia
皿	mbiaii
苠	mbii
抿	mbiu
闵	mboi
黾	mboia
闽	mboiia
旻	mboio
悯	mboo
忞	mbov
鳘	mbuv
慜	mbuvo
敏	mbuvuv
碈	mbvu
珉	mbvv
玟	mbvvov
淼	mcaa
缪	mcaaa
缈	mcaai
渺	mcai
妙	mcauiu
瞄	mcia
眇	mciai
藐	mcii
苗	mciiia
鹋	mciiu
描	mciu
喵	mcoi
庙	mcovia
邈	mcuooa
秒	mcuviu
杪	mcviuo
乜	mdaa
鍪	mdao
牟	mdaouv
蠛	mdia
蛑	mdiaa
眸	mdiaao
侔	mdiao
蔑	mdii
哞	mdoa
谋	mdoavi
咩	mdoo
篾	mduvia
某	mdvivv
灭	mdvoui
麽	meovua
么	meuaoo
缦	mfaa
满	mfaiiv
漫	mfaoii
嫚	mfau
幔	mfia
螨	mfiai
瞒	mfiaii
蔓	mfii
颟	mfiiv
镘	mfio
谩	mfoa
曼	mfoi
慢	mfoooi
熳	mfou
蛮	mfov
鳗	mfua
馒	mfuaoi
鞔	mfvi
鬘	mfvio
墁	mfvo
埋	mfvoia
溟	mgaoao
洺	mgau
瞑	mgia
螟	mgiao
茗	mgii
蓂	mgiio
铭	mgio
命	mgivoa
冥	mgoa
暝	mgoi
明	mgoiuu
鸣	mgou
名	mguaoo
酩	mgviua
买	mhaoov
荬	mhiiao
唛	mhovvi
脉	mhuo
卖	mhuoao
迈	mhva
劢	mhvaa
霾	mhvo
売	mhvou
麦	mhvv
母	mjaaov
楘	mjaov
姆	mjau
沐	mjav
睦	mjia
目	mjiavv
墓	mjii
募	mjiia
慕	mjiii
苜	mjiiia
幕	mjiiia
暮	mjiio
钼	mjio
拇	mjiu
仫	mjiua
𧿹	mjoi
亩	mjovia
穆	mjuv
毪	mjuva
牧	mjuvuv
牡	mjuvv
模	mjvi
坶	mjvo
木	mjvv
汨	mkaoi
洣	mkaou
弭	mkav
弥	mkavua
眯	mkiaou
蘼	mkii
芈	mkiv
谜	mkoa
幂	mkoai
谧	mkoao
祕	mkoaoa
祢	mkoau
蜜	mkoo
密	mkooia
嘧	mkoooa
咪	mkoou
迷	mkou
敉	mkouu
米	mkouvv
靡	mkov
縻	mkova
糜	mkovo
麋	mkovou
猕	mkua
觅	mkuo
脒	mkuou
醾	mkvi
醚	mkviou
陌	mlai
漠	mlaiio
没	mlauaa
嫫	mlaui
嬷	mlauo
沫	mlav
默	mlia
冒	mliai
墨	mliav
摹	mlii
蓦	mliia
蘑	mliio
莫	mliioi
藦	mliiov
茉	mliiv
镆	mlio
抹	mliu
尛	mliui
摸	mliuii
谟	mloa
嗼	mloi
寞	mloo
磨	mlov
摩	mlovi
瘼	mlovii
魔	mlovui
馍	mlua
膜	mluiio
貘	mluo
貊	mluov
秣	mluv
万	mlva
靺	mlviv
殁	mlvu
无	mlvv
末	mlvviu
耱	mlvvo
缅	mmaa
绵	mmaaui
娩	mmau
湎	mmav
沔	mmavi
冕	mmia
眠	mmiaav
眄	mmiav
偭	mmiv
愐	mmoo
勉	mmua
免	mmuaia
𩾃	mmuau
腼	mmuv
丏	mmvi
勔	mmvu
棉	mmvuia
面	mmvuia
懑	mnaioa
汶	mnao
钔	mnio
们	mnioia
扪	mniuoi
闷	mnoi
门	mnoiaa
焖	mnou
漭	mpaiiv
蟒	mpia
莽	mpii
茫	mpiiao
芒	mpiio
忙	mpooov
氓	mpov
邙	mpova
盲	mpovia
牻	mpuv
牤	mpuvov
杧	mpvo
厖	mpvu
硭	mpvuii
谬	mqoaao
濛	mrai
勐	mraia
孟	mraiia
虻	mria
蜢	mriaa
蠓	mriai
幪	mriaii
㠓	mriaii
萌	mrii
瞢	mriii
鹲	mriiu
甍	mriiv
蒙	mriivv
锰	mrio
盟	mroiia
懵	mroo
獴	mrua
猛	mruaai
朦	mrui
艨	mruu
艋	mruua
檬	mrviio
礞	mrvu
梦	mrvvua
马	msaa
孖	msai
妈	msauaa
蚂	msia
蟆	msiai
祃	msoa
吗	msoaav
骂	msoo
嘛	msoovu
麻	msov
犸	msuaaa
杩	msva
码	msvuaa
玛	msvv
湄	mwaa
眉	mwai
郿	mwaia
鹛	mwaiu
渼	mwao
媒	mwau
媚	mwaua
浼	mwauai
媄	mwauo
妹	mwauvv
嵋	mwiaai
莓	mwii
镁	mwio
镅	mwioa
袂	mwoa
昧	mwoi
寐	mwoo
煤	mwou
美	mwouvu
槑	mwovo
猸	mwua
魅	mwuivv
每	mwuvaa
楣	mwva
酶	mwvi
霉	mwvo
枚	mwvu
梅	mwvuva
玫	mwvv
瑂	mwvva
蟊	mzao
矛	mzaoai
瞀	mzaoi
蝥	mzaoia
泖	mzau
帽	mzia
峁	mziau
眊	mziauv
茂	mzii
茅	mziia
鄚	mziiai
茆	mziiu
芼	mziiuv
锚	mzio
铆	mziou
昴	mzoi
旄	mzov
袤	mzovao
猫	mzua
卯	mzuaa
贸	mzuaao
貌	mzuo
耄	mzuou
牦	mzuv
毛	mzuvva
懋	mzva
楙	mzvao
髦	mzviuv
瑁	mzvv
您	nbiuoa
溺	ncaa
尿	ncavaa
嬲	ncia
茑	nciiua
脲	ncua
袅	ncuaov
陧	ndai
涅	ndaoiv
嵲	ndia
蘖	ndii
孽	ndiiai
菍	ndiii
糵	ndiio
镊	ndio
镍	ndiou
捏	ndiuoi
啮	ndoi
蹑	ndoivi
嗫	ndov
臬	nduivv
颞	ndvi
聂	ndviao
耨	ndvv
那	neavai
哪	neoa
讷	neoaia
呢	neoavu
呐	neoi
难	nfaoio
婻	nfauuo
囡	nfia
男	nfiaau
蝻	nfiau
萳	nfii
喃	nfouoi
南	nfuoia
腩	nfuu
赧	nfvo
楠	nfvuoi
泞	ngaooa
拧	ngiuoo
佞	ngiv
咛	ngoo
甯	ngooo
宁	ngoovi
凝	ngovua
狞	nguaoo
聍	ngvi
柠	ngvooa
鼐	nhau
奶	nhauau
乃	nhauu
艿	nhii
萘	nhiiv
佴	nhiv
虐	nhivva
疟	nhovva
氖	nhuvau
迺	nhvi
奈	nhvu
耐	nhvuvi
柰	nhvv
努	njau
弩	njaua
驽	njauaa
孥	njauai
奴	njauao
胬	njaui
怒	njauoa
砮	njauv
傉	njivuv
笯	njuvau
泥	nkaavu
𨺙	nkai
妮	nkau
尼	nkavua
睨	nkia
伲	nkiav
薿	nkii
铌	nkio
倪	nkiu
你	nkiuai
拟	nkiuao
昵	nkoi
怩	nkoo
逆	nkou
旎	nkov
麑	nkovu
猊	nkua
疑	nkuaa
鲵	nkuau
腻	nkuvvi
匿	nkviiv
霓	nkvo
坭	nkvoa
娜	nlauav
女	nlauvv
傩	nlia
𦰡	nlii
钕	nlio
锘	nlioi
搦	nliu
挪	nliuav
诺	nloaii
喏	nloi
懦	nloo
糯	nlou
衄	nluiai
恧	nlvuoa
蔫	nmii
念	nmiooa
撵	nmiu
捻	nmiui
拈	nmiuiv
粘	nmouiv
鲇	nmua
黏	nmuviv
年	nmuvvi
辗	nmva
廿	nmviiv
埝	nmvo
碾	nmvu
辇	nmvv
嫩	nnauvi
恁	nniuoa
攮	npiuvi
曩	npoi
囔	npovia
馕	npuavi
齉	npui
囊	npvioo
纽	nqaa
妞	nqauai
钮	nqio
拗	nqiu
扭	nqiuai
忸	nqooai
狃	nquaai
牛	nquvvi
杻	nqvavi
能	nraoua
纳	nsaaia
乸	nsai
钠	nsio
镎	nsioi
捺	nsiu
拿	nsiviu
衲	nsoa
肭	nsui
雫	nsvovi
暖	ntoiuo
内	nwiauo
馁	nwuauo
嬢	nxau
娘	nxauoa
酿	nxvioa
浓	nyaoau
侬	nyioau
农	nyoaua
哝	nyoo
脓	nyuoau
秾	nyuv
蛲	nzia
铙	nzio
挠	nziuva
呶	nzoa
闹	nzoiov
恼	nzooov
猱	nzua
峱	nzuaa
脑	nzuovu
臑	nzuv
垴	nzvo
硇	nzvu
孬	nzvuau
瑙	nzvv
桡	nzvva
嫔	pbau
姘	pbauou
拚	pbiu
拼	pbiuou
频	pbiv
颦	pbivu
品	pboooo
贫	pbuoao
牝	pbuv
聘	pbviia
榀	pbvo
玭	pbvv
缥	pcaa
嫖	pcau
漂	pcavia
螵	pcia
瞟	pciavi
薸	pcii
嘌	pcovia
瓢	pcvi
剽	pcvii
朴	pcvio
飘	pcviua
票	pcvivv
殍	pcvu
苤	pdiivu
抔	pdiu
掊	pdiuo
撇	pdiuou
瞥	pdouia
剖	pdov
裒	pdovu
氕	pduvuu
垺	pdvouo
爿	pfai
泮	pfao
潘	pfauou
畔	pfia
蟠	pfiau
盼	pfiauo
袢	pfoa
襻	pfoav
蹒	pfoi
叛	pfou
判	pfouii
胖	pfuo
槃	pfuu
盘	pfuuia
磐	pfuuvu
柈	pfvo
攀	pfvuvu
涄	pgai
洴	pgao
娉	pgau
淜	pgauu
帡	pgia
蚲	pgiav
苹	pgii
俜	pgiia
萍	pgiiav
荓	pgiio
凭	pgiuua
评	pgoa
瓶	pgouva
呯	pgovo
鲆	pgua
乒	pguiuu
平	pgvouv
坪	pgvovo
砯	pgvuao
枰	pgvv
玶	pgvvv
湃	phai
派	phauuu
俳	phii
蒎	phiia
排	phiuiv
拍	phiuui
哌	phouuu
迫	phui
牌	phuiui
徘	phuu
簰	phuv
濮	pjai
潽	pjaou
溥	pjav
浦	pjavia
圃	pjia
仆	pjii
蒲	pjiia
蒱	pjiii
菩	pjiio
葡	pjiiu
铺	pjio
镤	pjioi
镨	pjioo
扑	pjiuio
谱	pjoaou
蹼	pjoi
噗	pjoii
普	pjouoi
匍	pjua
氆	pjuv
穙	pjuvi
酺	pjvi
墣	pjvoi
璞	pjvv
澼	pkaau
淠	pkai
陴	pkaiu
阰	pkaiv
疋	pkaivu
媲	pkau
皮	pkauao
劈	pkava
譬	pkavo
䴙	pkavov
屁	pkavv
甓	pkavva
僻	pkia
罴	pkiao
蜱	pkiaui
毗	pkiav
蚍	pkiava
芘	pkii
苉	pkiiv
铍	pkio
擗	pkiu
披	pkiuau
批	pkiuva
仳	pkiv
伾	pkivu
噼	pkoav
啤	pkou
癖	pkov
疲	pkovau
庀	pkovu
痞	pkovv
鲏	pkua
狉	pkuav
郫	pkui
貔	pkuo
脾	pkuuia
霹	pkvo
圮	pkvoa
埤	pkvou
鼙	pkvoui
坯	pkvov
嚭	pkvovu
丕	pkvu
邳	pkvua
匹	pkvuaa
砒	pkvuv
琵	pkvv
枇	pkvva
泼	plaa
婆	plaaau
颇	plau
钷	plio
䥽	plioa
钋	plioio
攴	pliv
粕	plou
哱	plouo
皤	pluiu
鄱	pluo
笸	pluv
酦	plvia
叵	plvo
坡	plvoau
破	plvuau
珀	plvv
骈	pmaa
骗	pmaaoa
㛹	pmau
偏	pmioav
翩	pmoaao
谝	pmoao
蹁	pmoi
片	pmuiva
胼	pmuo
犏	pmuv
篇	pmuvoa
楩	pmvivi
𡎚	pmvo
湓	pnauoa
喷	pnouov
盆	pnuoia
滂	ppaovo
螃	ppiaov
旁	ppovov
庞	ppovvu
逄	ppua
鳑	ppuao
乓	ppui
雱	ppvi
耪	ppvv
泙	prav
澎	pravoo
弸	pravu
蟛	pria
蓬	prii
芃	priiu
抨	priu
捧	priuvv
怦	proo
嘭	prov
烹	provoo
鹏	pruu
朋	pruuu
篷	pruv
膨	pruvo
椪	prvouv
砰	prvu
碰	prvuou
硼	prvuu
棚	prvuuu
潖	psavvi
帕	psiaui
葩	psii
趴	psoi
啪	psoiuu
怕	psooui
舥	psuu
爬	psuuai
筢	psuv
杷	psva
琶	psvvai
辔	pwaa
陪	pwaiov
赔	pwao
沛	pwav
帔	pwia
锫	pwio
佩	pwiuav
裴	pwiv
旆	pwov
呸	pwovui
衃	pwui
胚	pwuvui
醅	pwvi
配	pwviav
霈	pwvo
培	pwvoov
泡	pzauaa
抛	pziuua
袍	pzoa
跑	pzoiua
咆	pzou
疱	pzov
庖	pzovu
狍	pzua
脬	pzuu
匏	pzvuua
骎	qbaa
沁	qbaoao
溱	qbav
螓	qbia
嵚	qbiai
侵	qbiavv
芹	qbii
芩	qbiii
钦	qbio
锓	qbioa
衾	qbioo
禽	qbiov
擒	qbiu
揿	qbiui
噙	qboi
吣	qboo
寝	qbooov
慬	qboov
嗪	qbov
亲	qbovvv
勤	qbvi
檎	qbvio
覃	qbvioi
琴	qbvv
秦	qbvvuv
缲	qcaaoo
峭	qcia
睄	qciai
瞧	qciaio
俏	qcii
荞	qciiu
锹	qcio
劁	qcioi
侨	qciu
雀	qciui
撬	qciuu
诮	qcoa
谯	qcoai
跷	qcoi
窍	qcoo
憔	qcooi
悄	qcooio
愀	qcoou
敲	qcov
乔	qcuvui
翘	qcva
樵	qcvio
鞒	qcviu
巧	qcviva
橇	qcvu
硚	qcvuu
硗	qcvuv
桥	qcvuvu
锲	qdio
怯	qdoo
惬	qdoov
窃	qdoova
妾	qdov
癿	qdui
郄	qduo
箧	qduvvv
切	qdvaau
砌	qdvu
挈	qdvv
绽	qfaa
沾	qfai
湛	qfav
展	qfavvi
瞻	qfia
嶦	qfiau
崭	qfiav
蘸	qfii
搌	qfiu
偡	qfiv
占	qfivoo
战	qfivva
谵	qfoa
站	qfoviv
旃	qfovu
鹯	qfovua
飐	qfuai
詹	qfuaov
毡	qfuv
斩	qfvauu
栴	qfvu
盏	qfvv
栈	qfvvv
清	qgavvi
蜻	qgia
黥	qgiao
圊	qgiav
擎	qgii
苘	qgiii
檠	qgiiv
倩	qgiv
倾	qgivav
綮	qgoa
请	qgoavv
晴	qgoi
情	qgoovv
庆	qgov
勍	qgova
庼	qgovva
凊	qgovvv
鲭	qgua
卿	qguaav
謦	qguo
氢	qguv
氰	qguvv
顷	qgva
轻	qgvaao
罄	qgvo
磬	qgvov
碃	qgvu
青	qgvv
蒛	qhii
阙	qhoi
阕	qhoia
瘸	qhova
缺	qhuvav
鹊	qhvi
榷	qhvo
却	qhvoai
悫	qhvoo
埆	qhvou
碏	qhvu
确	qhvuua
棤	qhvv
驻	qjaa
纻	qjaao
贮	qjao
注	qjaovv
渚	qjau
潴	qjaua
洙	qjauv
助	qjia
瞩	qjiaa
蠋	qjiai
蛀	qjiao
蛛	qjiau
苎	qjiio
苧	qjiioo
茱	qjiiu
铸	qjio
伫	qjioo
铢	qjiou
住	qjiovv
拄	qjiu
侏	qjiuv
诸	qjoa
祝	qjoaou
诛	qjoau
嘱	qjoav
烛	qjou
炷	qjouo
麈	qjov
疰	qjovo
瘃	qjovv
主	qjovvi
猪	qjua
橥	qjuav
煮	qjuo
翥	qjuoa
舳	qjuu
竹	qjuv
邾	qjuva
箸	qjuvu
筑	qjuvv
朱	qjuvvi
竺	qjuvvv
杼	qjva
柱	qjvo
槠	qjvoa
柷	qjvou
株	qjvu
砫	qjvuo
逐	qjvuoa
珠	qjvv
呇	qkaao
绮	qkaav
骐	qkaavi
泣	qkao
汔	qkau
婍	qkauv
汽	qkauvv
漆	qkav
沏	qkava
淇	qkavi
柒	qkavv
岂	qkia
屺	qkiaa
蛴	qkiao
俟	qkiaou
岐	qkiau
崎	qkiav
蜞	qkiavi
畦	qkiavo
芪	qkii
芑	qkiia
葺	qkiio
蕲	qkiiou
萋	qkiiv
萁	qkiivi
企	qkiivi
锜	qkio
歧	qkiv
启	qkoa
祈	qkoau
讫	qkoauv
祺	qkoav
棨	qkoavv
蹊	qkoi
跂	qkoiu
踦	qkoiv
器	qkoo
愭	qkoou
弃	qkov
旗	qkovu
嘁	qkovui
齐	qkovui
凄	qkovv
麒	qkovvi
鳍	qkua
鲯	qkuav
脐	qkuo
耆	qkuoo
颀	qkuu
迄	qkuv
乞	qkuva
憩	qkuvo
气	qkuvva
七	qkva
郪	qkvaai
妻	qkvaau
杞	qkvav
綦	qkvia
桤	qkviai
欺	qkviu
碁	qkviv
圻	qkvo
起	qkvoav
埼	qkvov
戚	qkvui
欹	qkvuu
磜	qkvuua
碛	qkvuvv
碶	qkvuvv
棋	qkvv
玘	qkvva
栖	qkvvi
槭	qkvvu
亓	qkvvui
琦	qkvvv
琪	qkvvvi
契	qkvvvu
驱	qlaa
灈	qlai
渠	qlav
屈	qlavai
黢	qliaa
蛆	qliai
蛐	qliaia
蠼	qliaia
氍	qliau
岖	qliav
曲	qliavi
蕖	qlii
蘧	qliii
龋	qliv
觑	qlivi
诎	qloa
袪	qloav
祛	qloavo
阒	qloi
焌	qlou
癯	qlov
竘	qlovu
劬	qlua
鸲	qluau
鼩	qlui
躯	qluivu
衢	qluu
胠	qluv
娶	qlvi
取	qlviao
麴	qlviu
趣	qlvo
去	qlvoao
坥	qlvoi
趋	qlvou
磲	qlvu
区	qlvuoa
璩	qlvv
㭕	qlvvo
麹	qlvvu
纤	qmaa
缱	qmaai
阡	qmai
浅	qmav
汧	qmavv
潜	qmavvu
遣	qmia
黔	qmiai
嵌	qmiav
岍	qmiavv
茜	qmii
荨	qmiia
伣	qmiiau
蒨	qmiii
芡	qmiiu
芊	qmiiuv
铅	qmio
钤	qmioi
钎	qmiou
钳	qmiov
钱	qmiovv
仟	qmiu
掮	qmiuo
扦	qmiuu
虔	qmivo
佥	qmivoo
谴	qmoa
谦	qmoaou
骞	qmoo
悭	qmooi
搴	qmooiu
褰	qmooo
慊	qmooou
歉	qmou
前	qmouui
欠	qmua
鹐	qmuau
愆	qmuu
肷	qmuua
签	qmuv
箝	qmuvi
千	qmuvii
迁	qmuvo
堑	qmva
椠	qmvav
圲	qmvo
墘	qmvou
杄	qmvu
牵	qmvuuv
缜	qnaa
纼	qnaaa
浈	qnai
阵	qnaiva
赈	qnao
帧	qnia
畛	qniai
侦	qnii
蓁	qniiv
葴	qniivu
针	qnio
镇	qniouo
振	qniu
揕	qniuv
贞	qniv
祯	qnoa
袗	qnoai
诊	qnoaiu
鸩	qnoau
禛	qnoauo
昣	qnoi
疹	qnov
胗	qnui
真	qnuouo
朕	qnuouv
箴	qnuv
稹	qnuvu
臻	qnva
轸	qnvai
斟	qnvi
鬒	qnviu
甄	qnviv
桢	qnviva
枕	qnvo
圳	qnvou
震	qnvovu
砧	qnvu
珍	qnvv
榛	qnvvv
瑧	qnvvvv
涨	qpaava
障	qpai
账	qpao
漳	qpaov
嫜	qpau
张	qpavuv
帐	qpia
嶂	qpiao
幛	qpiaov
蟑	qpiaov
掌	qpioiu
仉	qpiu
仗	qpiv
暲	qpoi
彰	qpov
鄣	qpova
瘴	qpovo
章	qpovuo
獐	qpua
胀	qpuuva
樟	qpvo
丈	qpvuoo
杖	qpvv
璋	qpvvo
泅	qqaiav
巯	qqao
赇	qqaov
蚯	qqia
虬	qqiaa
囚	qqiaii
蝤	qqiao
萩	qqiiu
𨱇	qqio
仇	qqiu
俅	qqiv
遒	qqou
糗	qqouu
酋	qqouvi
鳅	qqua
訄	qquao
犰	qquau
丘	qqui
邱	qquia
鼽	qquiu
鹙	qquv
秋	qquvou
裘	qqvi
逑	qqvio
鞧	qqviou
求	qqviov
楸	qqvu
璆	qqvv
球	qqvvvi
烝	qraioo
睁	qria
峥	qriau
蒸	qrii
铮	qrio
钲	qriov
拯	qriu
挣	qriuua
诤	qroa
证	qroavi
怔	qroo
郑	qrou
症	qrov
狰	qrua
争	qruaav
征	qruu
筝	qruv
政	qrvi
整	qrvivi
正	qrvivi
洽	qsaivo
髂	qsia
葜	qsii
掐	qsiu
拤	qsiui
恰	qsooiv
绻	qtaa
劝	qtaoau
婘	qtau
蜷	qtia
畎	qtiav
荃	qtii
颧	qtiiv
佺	qtiivv
铨	qtio
全	qtivvi
诠	qtoa
悛	qtoo
拳	qtou
券	qtouau
痊	qtov
鳈	qtua
泉	qtuiaa
筌	qtuv
辁	qtva
权	qtvaoo
醛	qtvi
鬈	qtvio
棬	qtvo
犬	qtvu
瑔	qtvv
逡	qwaooa
群	qwavou
囷	qwiauv
裙	qwoa
谆	qwoao
窀	qwoo
准	qwovio
衠	qwuu
屯	qwvaia
戕	qxaiva
嫱	qxau
蜣	qxia
戗	qxiav
蔷	qxii
蔃	qxiia
锵	qxio
镪	qxioa
锖	qxiov
襁	qxoa
跄	qxoi
呛	qxoiaa
羌	qxou
羟	qxoua
炝	qxoui
腔	qxuooa
枪	qxviaa
墙	qxvo
樯	qxvu
玱	qxvv
䓖	qyii
茕	qyiiav
穷	qyooau
穹	qyooav
筇	qyuvvi
邛	qyvi
蛩	qyvii
銎	qyviio
跫	qyvio
琼	qyvvov
汭	rbaiau
蚋	rbia
蕊	rbii
芮	rbiii
蕤	rbiiv
锐	rbioou
睿	rbiv
叡	rbiva
枘	rbviau
瑞	rbvvia
柔	rdaovv
肉	rdiaii
揉	rdiuao
蹂	rdoiao
宍	rdoo
糅	rdou
鞣	rdviao
惹	reiioa
热	reiuoo
染	rfauvv
蚺	rfia
䎃	rfiaa
冉	rfiaiv
苒	rfii
燃	rfouua
然	rfuaoo
髯	rfviia
缛	rjaa
洳	rjaau
汝	rjaauv
𦈡	rjaav
孺	rjai
嬬	rjau
如	rjauoo
濡	rjav
溽	rjavu
蠕	rjia
茹	rjii
薷	rjiiv
蓐	rjiivu
铷	rjio
儒	rjivoa
襦	rjoa
褥	rjoavu
嚅	rjov
乳	rjuo
入	rjuoo
颥	rjvo
辱	rjvuvi
驲	rkaaoi
䒤	rkiioi
日	rkoii
婼	rlau
弱	rlavav
鄀	rlii
蒻	rliia
偌	rliiiv
爇	rliiv
若	rliivu
挼	rliu
箬	rluvii
纫	rnaa
纴	rnaau
刃	rnau
忍	rnauoa
妊	rnauu
仞	rnia
人	rnii
荏	rniii
任	rniuvi
仁	rnivvv
衽	rnoa
讱	rnoaa
认	rnoaii
饪	rnua
稔	rnuv
壬	rnuviv
轫	rnva
韧	rnvvau
瀼	rpaovo
蘘	rpii
儴	rpio
攘	rpiuov
禳	rpoa
让	rpoaiv
嚷	rpoovo
瓤	rpov
穰	rpuvov
壤	rpvoov
仍	rriauu
扔	rriuau
礽	rroaau
阮	rtaivv
媆	rtau
朊	rtuvvu
软	rtvaua
堧	rtvovu
瓀	rtvv
润	rwaoia
闰	rwoivv
绒	ryaa
溶	ryaooa
嵘	ryia
蝾	ryiai
蓉	ryii
茸	ryiiv
荣	ryiivv
镕	ryio
冗	ryoa
容	ryoouo
熔	ryouoo
狨	ryua
肜	ryuuuu
榕	ryvo
融	ryvoia
戎	ryvv
瑢	ryvvo
绕	rzaava
娆	rzauva
荛	rzii
扰	rziuvu
饶	rzuava
绥	sbaa
隧	sbai
濉	sbaia
祟	sbaiv
随	sbaivu
髓	sbia
岁	sbiaua
荽	sbii
谇	sboa
襚	sboao
虽	sboiav
邃	sboo
遂	sbou
燧	sbouo
旞	sbov
穟	sbuv
穗	sbuvvi
碎	sbvuov
璲	sbvv
溲	sdauiv
瞍	sdia
螋	sdiau
蒐	sdii
薮	sdiiou
锼	sdio
擞	sdiu
搜	sdiuui
嗾	sdoo
嗖	sdouiv
嗽	sdov
廋	sdovu
飕	sdua
馊	sduaui
叟	sdui
艘	sduu
涩	seaauo
㴔	seau
洓	seav
铯	seioua
塞	seoovo
啬	seuoia
穑	seuv
瑟	sevvoa
璱	sevvv
毵	sfao
叁	sfaovv
潵	sfav
伞	sfiouu
馓	sfuavi
散	sfviuv
三	sfvvvv
思	shiaoa
噻	shoo
赛	shooao
鳃	shua
腮	shuiav
骕	sjaa
溯	sjao
涑	sjav
鹔	sjavu
肃	sjavvi
蔌	sjii
苏	sjiiau
俗	sjiuoi
僳	sjiv
傃	sjivv
谡	sjoa
诉	sjoauu
蹜	sjoi
宿	sjoo
窣	sjooo
愫	sjoov
塑	sjou
嗉	sjov
夙	sjua
稣	sjuauv
觫	sjuav
簌	sjuv
粟	sjvi
速	sjvioa
酥	sjviu
甦	sjviuv
素	sjvv
丝	skaa
驷	skaai
缌	skaaia
涘	skaao
鸶	skaau
汜	skaav
泗	skai
厶	skao
姒	skau
巳	skav
澌	skavi
司	skavoo
㟃	skiaa
蛳	skiai
兕	skiau
四	skiaua
锶	skioi
撕	skiu
祀	skoaa
咝	skoaaa
嗣	skoiav
嘶	skov
凘	skovv
饲	skua
飔	skuai
虒	skuu
笥	skuv
私	skuvao
斯	skvi
肆	skvia
楒	skviav
寺	skvo
厮	skvu
死	skvuua
耜	skvv
缩	slaaoo
娑	slai
挲	slaii
溹	slau
睃	slia
蓑	slii
锁	slioio
些	sliv
唆	sloa
唢	sloi
嗍	sloo
羧	slou
嗦	slouoo
索	sluoaa
所	sluuuu
桫	slva
梭	slvaou
琐	slvv
森	snvvvv
颡	spaovu
桑	spaovv
搡	spiuao
嗓	spoaoa
丧	spuoau
磉	spvuao
僧	srioui
洒	ssavia
萨	ssiiai
撒	ssiuvi
仨	ssiv
飒	ssovua
脎	ssuu
靸	ssvi
卅	ssvuii
蒜	stiivv
狻	stuaao
算	stuvia
酸	stviao
孙	swaiiu
荪	swii
隼	swio
损	swiuoa
狲	swua
飧	swuai
笋	swuvav
榫	swviov
飱	swvu
娀	syau
淞	syavuo
嵩	syia
崧	syiav
怂	syii
菘	syiiv
耸	syiivi
㧐	syiu
诵	syoa
讼	syoau
悚	syoov
宋	syoovv
送	syouoa
竦	syov
凇	syovv
颂	syuovu
松	syvuoa
缫	szaa
骚	szaaao
溞	szaaoo
嫂	szau
搔	sziuao
扫	sziuav
燥	szouoo
瘙	szov
鳋	szua
臊	szuooo
埽	szvoav
退	tbavoa
蜕	tbiaou
推	tbiuio
褪	tboaav
煺	tbou
腿	tbuavv
魋	tbui
颓	tbuv
忒	tbvoao
粜	tcai
嬥	tcau
迢	tcauoa
眺	tcia
蜩	tciau
佻	tciu
挑	tciuuo
龆	tciv
祧	tcoa
跳	tcoi
窕	tcoo
鲦	tcua
条	tcuavv
朓	tcuu
笤	tcuvau
髫	tcviau
贴	tdaoiv
帖	tdia
骰	tdiau
萜	tdii
偷	tdiivu
铁	tdio
投	tdiu
头	tdoovu
透	tduvoa
餮	tdvuio
铽	teiovo
特	teuvvo
忑	tevi
慝	tevio
滩	tfaa
潭	tfav
炭	tfia
菼	tfii
贪	tfio
怹	tfioa
钽	tfioo
倓	tfioou
锬	tfioou
摊	tfiu
探	tfiuoa
忐	tfiv
谭	tfoa
袒	tfoao
叹	tfoaoo
谈	tfoaou
昙	tfoi
啴	tfoo
惔	tfooo
郯	tfou
痰	tfov
瘫	tfova
毯	tfuvou
坛	tfvo
坦	tfvooi
坍	tfvou
檀	tfvov
碳	tfvu
榃	tfvv
璮	tfvvo
渟	tgao
婷	tgau
汀	tgavii
蜓	tgia
䗴	tgiau
葶	tgii
莛	tgiiu
停	tgiovo
挺	tgiu
侹	tgiuv
烃	tgou
烶	tgouu
听	tgouuv
亭	tgov
庭	tgovuv
艇	tguuuv
廷	tguv
颋	tguvv
霆	tgvo
圢	tgvov
桯	tgvovv
梃	tgvu
厅	tgvuvi
珽	tgvv
邰	thao
炱	thaoo
台	thaooo
汰	thav
苔	thii
薹	thiiv
钛	thio
抬	thiuao
跆	thoiao
鲐	thua
胎	thuaoo
肽	thuv
酞	thvi
态	thvuoa
太	thvuoo
泰	thvv
涂	tjaivv
屠	tjav
图	tjiaua
荼	tjii
葖	tjiio
菟	tjiiu
钍	tjio
凸	tjiv
途	tjivoa
突	tjoo
吐	tjovoo
兔	tjua
腯	tjuu
徒	tjuuvo
秃	tjuv
稌	tjuvi
酴	tjvi
梌	tjviv
堍	tjvo
土	tjvoo
㻬	tjvv
缇	tkaa
绨	tkaao
涕	tkaoua
媞	tkau
屉	tkav
荑	tkii
锑	tkio
倜	tkiu
擿	tkiuo
体	tkiviu
裼	tkoa
踢	tkoi
剔	tkoii
蹄	tkoio
题	tkoivu
啼	tkoo
惕	tkooo
悌	tkooou
剃	tkou
嚏	tkouo
鹈	tkouu
鳀	tkua
逖	tkuaoa
䴘	tkuu
醍	tkvi
梯	tkvo
趯	tkvoa
瑅	tkvv
替	tkvvoi
驼	tlaa
陀	tlai
沱	tlao
萚	tlii
铊	tlio
佗	tlioo
侂	tliov
拓	tliu
托	tliuuv
拖	tliuuv
跎	tloi
跅	tloiu
鼍	tloo
唾	tlouvi
庹	tlov
鸵	tlua
妥	tluo
脱	tluouo
乇	tluv
箨	tluvi
椭	tlvaiv
橐	tlvi
酡	tlvio
坨	tlvo
砣	tlvu
柝	tlvuu
沺	tmai
淟	tmaia
湉	tmao
添	tmavvu
畋	tmia
觍	tmiai
田	tmiavi
黇	tmiii
掭	tmiu
阗	tmoi
晪	tmoii
恬	tmoouv
畑	tmou
腆	tmui
舔	tmuv
甜	tmuvvi
填	tmvouo
殄	tmvu
忝	tmvv
瑱	tmvvu
兲	tmvvuo
天	tmvvuo
烫	tpaa
溏	tpao
帑	tpau
螳	tpia
螗	tpiao
倘	tpii
傥	tpiio
棠	tpio
铴	tpioa
䣘	tpioai
镗	tpioi
镋	tpioio
堂	tpiovo
搪	tpiu
嘡	tpoi
蹚	tpoii
羰	tpou
糖	tpouov
鄌	tpov
唐	tpovav
饧	tpua
膛	tpui
躺	tpuiio
醣	tpvi
樘	tpvio
趟	tpvo
塘	tpvoov
瑭	tpvv
耥	tpvvi
藤	triiuo
誊	trou
熥	troua
疼	trovua
螣	truo
䲢	truou
縢	truouv
滕	truouv
腾	truouv
溻	tsao
她	tsauai
他	tsiaia
挞	tsiuvu
祂	tsoa
褟	tsoao
踏	tsoi
蹋	tsoio
遢	tsoioa
阘	tsoioi
趿	tsoiu
闼	tsoiv
它	tsooua
鳎	tsua
獭	tsuavi
鞳	tsvi
榙	tsvii
塌	tsvo
榻	tsvoi
塔	tsvoii
彖	ttaa
湍	ttaiai
疃	ttia
圕	ttiaa
团	ttiavi
抟	ttiuvv
煓	ttouia
猯	ttuaia
臀	twavuu
氽	twia
暾	twoiov
忳	twoo
焞	twou
饨	twua
鲀	twuav
豚	twuvua
坉	twvo
吞	twvvoo
统	tyaa
潼	tyao
通	tyaooa
㛚	tyau
瞳	tyia
峂	tyiau
同	tyiavo
茼	tyii
铜	tyioia
捅	tyiu
佟	tyiua
仝	tyiv
嗵	tyoa
哃	tyoi
曈	tyoio
恸	tyoo
烔	tyou
童	tyov
𦒍	tyova
痛	tyovao
彤	tyua
鲖	tyuai
穜	tyuv
筒	tyuvia
桶	tyvaoi
桐	tyvi
酮	tyvii
橦	tyvov
砼	tyvu
绦	tzaa
绹	tzaau
陶	tzaiua
滔	tzau
淘	tzauau
洮	tzauo
涛	tzav
弢	tzavi
萄	tzii
掏	tziuua
讨	tzoavi
慆	tzoo
啕	tzou
饕	tzov
鼗	tzuo
逃	tzuooa
桃	tzvu
套	tzvuvi
韬	tzvvu
梼	tzvvv
陲	wbaiuv
锤	wbiouv
捶	wbiu
倕	wbiuv
吹	wbouai
炊	wbouua
垂	wbuviv
棰	wbvu
槌	wbvuia
绸	wdaa
丑	wdaivv
瞅	wdia
畴	wdiav
雠	wdio
犨	wdiov
抽	wdiuia
俦	wdiv
踌	wdoivv
惆	wdoo
瘳	wdov
臭	wdui
筹	wduv
愁	wduvoa
稠	wduvu
酬	wdviou
椆	wdvu
绾	wfaa
纨	wfaau
涴	wfao
湾	wfaovi
婉	wfau
婠	wfauo
妧	wfauv
蜿	wfia
畹	wfiao
蚖	wfiavv
芄	wfii
菀	wfiio
挽	wfiuua
晚	wfoiua
宛	wfoo
剜	wfooi
惋	wfooo
完	wfoovv
烷	wfou
弯	wfov
丸	wfuaoo
皖	wfui
腕	wfuo
脘	wfuoo
豌	wfvo
塆	wfvoo
椀	wfvooa
碗	wfvu
玩	wfvv
琬	wfvvo
顽	wfvvv
搋	wgiuuu
啜	wgoa
踹	wgoiia
嘬	wgoo
膪	wguovo
崴	whiavu
外	whuaio
歪	whvuvi
毋	wjaa
阢	wjai
骛	wjao
婺	wjaoa
鹜	wjaou
妩	wjau
鋈	wjaui
污	wjav
浯	wjavi
洿	wjavu
𣲘	wjavv
屋	wjavva
蜈	wjia
屼	wjiav
峿	wjiavi
芜	wjii
钨	wjio
铻	wjiov
侮	wjiu
捂	wjiuv
仵	wjiuvu
伍	wjivia
诬	wjoa
误	wjoaov
喔	wjoav
晤	wjoi
旿	wjoiu
悟	wjoo
寤	wjooa
忤	wjoou
怃	wjoov
呜	wjou
焐	wjouv
吴	wjov
亡	wjova
唔	wjovi
於	wjovio
庑	wjovv
痦	wjovvi
务	wjua
乌	wjuaa
邬	wjuaai
勿	wjuau
鼯	wjui
舞	wjuv
迕	wjuvo
午	wjuvu
物	wjuvua
牾	wjuvv
吾	wjvi
郚	wjvia
五	wjviav
巫	wjvii
恶	wjvio
鹀	wjviu
靰	wjviv
雾	wjvo
坞	wjvou
圬	wjvov
兀	wjvu
戊	wjvua
武	wjvv
梧	wjvvi
鹉	wjvvu
杌	wjvvua
珸	wjvvv
珷	wjvvvv
池	wkaa
驰	wkaaa
蚩	wkai
媸	wkau
弛	wkava
迟	wkavoa
螭	wkia
眙	wkiaa
眵	wkiau
茌	wkii
侈	wkiu
傺	wkiua
摛	wkiuo
持	wkiuvo
齿	wkiv
嗤	wkoa
褫	wkoau
踟	wkoiu
叱	wkou
炽	wkouo
吃	wkouva
哧	wkov
啻	wkovo
痴	wkovuv
瘛	wkovv
饬	wkua
鸱	wkuau
魑	wkui
翅	wkuo
瓻	wkuov
彳	wkuu
胣	wkuuv
斥	wkuuvi
笞	wkuv
篪	wkuvu
耻	wkvi
敕	wkviu
豉	wkvo
墀	wkvoa
赤	wkvoui
漦	wkvv
渥	wlaav
戳	wlao
沃	wlauvu
蜗	wlia
幄	wliaa
偓	wliav
莴	wlii
握	wliuav
倭	wliuvi
龌	wliv
龊	wlivo
逴	wlivoa
踔	wloi
踒	wloiu
惙	wloo
窝	wloooi
斡	wluoio
肟	wluv
我	wluviv
辍	wlva
卧	wlviio
硪	wlvu
创	wmiaii
闯	wmoi
怆	wmoo
窗	wmooui
噇	wmoov
疮	wmov
床	wmovvv
纹	wnaa
温	wnaoii
蚊	wniaov
芠	wnii
闻	wnoi
问	wnoioo
阌	wnoiu
吻	wnou
炆	wnouo
紊	wnov
瘟	wnovo
文	wnovuo
刎	wnua
鳁	wnuao
璺	wnui
稳	wnuvua
辒	wnva
榅	wnvo
雯	wnvoov
韫	wnvvo
汪	wpavvi
罔	wpia
网	wpiauo
旺	wpoi
惘	wpoo
妄	wpova
忘	wpovoa
望	wpovvv
魍	wpui
往	wpuuov
辋	wpva
尪	wpvu
枉	wpvv
王	wpvviv
欻	wqouua
滃	wrauoa
蕹	wrii
蓊	wriiuo
嗡	wrouoa
鹟	wruo
翁	wruoao
瓮	wruova
汊	wsaa
叉	wsao
娲	wsau
姹	wsauo
娃	wsauvo
洼	wsav
蛙	wsia
凹	wsiai
畖	wsiau
嵖	wsiav
茶	wsii
茬	wsiiv
锸	wsio
镲	wsioo
侘	wsiooa
挖	wsiu
搽	wsiui
插	wsiuuv
佤	wsiv
袜	wsoa
衩	wsoaa
诧	wsoao
蹅	wsoi
窊	wsoou
察	wsooua
𥻗	wsou
哇	wsov
馇	wsua
詧	wsuao
岔	wsuo
腽	wsuoi
瓦	wsva
邷	wsvaa
杈	wsvao
檫	wsvo
垞	wsvoo
槎	wsvou
碴	wsvu
巛	wtaaaa
串	wtia
圌	wtiai
遄	wtiao
钏	wtio
喘	wtoiai
穿	wtoova
舛	wtua
川	wtui
舡	wtuu
船	wtuuua
氚	wtuv
椽	wtvaav
堾	wtvo
纬	wwaa
潍	wwaaa
维	wwaaio
卫	wwai
渭	wwaia
溦	wwaiai
涠	wwaiav
隈	wwaii
沩	wwao
娓	wwau
洈	wwaua
尾	wwav
螱	wwavi
慰	wwavo
洧	wwavu
尉	wwavv
𣲗	wwavva
围	wwia
帷	wwiai
遗	wwiao
胃	wwiau
峗	wwiaua
嵬	wwiaui
巍	wwiauv
畏	wwiav
囗	wwiavv
帏	wwiavv
萎	wwii
偎	wwiia
蔚	wwiiav
薇	wwiiu
苇	wwiiv
葳	wwiivu
伪	wwio
位	wwiovo
㧑	wwiu
伟	wwiv
谓	wwoa
诿	wwoau
唯	wwoi
喂	wwoia
闱	wwoiv
韪	wwoivv
惟	wwoo
煨	wwou
为	wwouao
煟	wwoui
炜	wwouv
痿	wwov
亹	wwovu
味	wwovvi
危	wwua
鳚	wwuaa
猥	wwuai
猬	wwuaia
鳂	wwuaia
鲔	wwuav
微	wwuu
艉	wwuua
魏	wwuv
委	wwuvau
逶	wwuvo
軎	wwvi
霨	wwvia
圩	wwvo
威	wwvu
桅	wwvua
硙	wwvui
碨	wwvuia
硊	wwvuu
违	wwvv
韦	wwvva
琟	wwvvi
未	wwvviu
玮	wwvvv
涌	wyaaoi
漴	wyai
翀	wyao
㳘	wyaov
崇	wyia
虫	wyiavi
茺	wyii
铳	wyio
摏	wyiu
宠	wyoo
忡	wyooi
冲	wyovia
充	wyovua
艟	wyuu
埫	wyvo
珫	wyvv
舂	wyvvui
薪	xbii
芯	xbiio
锌	xbio
伈	xbioa
鑫	xbioi
信	xbiovv
心	xboaoo
昕	xboi
忻	xboo
炘	xbou
辛	xbov
歆	xbovu
新	xbovuu
衅	xbui
囟	xbuiu
欣	xbuuua
馨	xbvouv
骁	xcaa
绡	xcaai
潇	xcai
消	xcaiou
洨	xcao
淆	xcau
涍	xcauov
崤	xcia
蟏	xciaii
萧	xcii
翛	xciiu
肖	xcio
削	xcioi
销	xcioio
逍	xcioo
小	xciuoo
啸	xcoa
晓	xcoi
宵	xcoo
恔	xcooo
咲	xcoou
敩	xcoouv
嚣	xcoov
哮	xcou
哓	xcov
鸮	xcovu
效	xcovuv
枭	xcua
虓	xcuai
猇	xcuaiv
魈	xcui
皛	xcuiu
孝	xcuo
箫	xcuv
筱	xcuvi
篠	xcuvii
笑	xcuvuv
霄	xcvo
枵	xcvov
硝	xcvu
缬	xdaa
绁	xdaav
瀣	xdai
𠙶	xdaia
泻	xdao
勰	xdau
澥	xdaua
屑	xdav
渫	xdavi
泄	xdavii
沤	xdavu
蝎	xdia
偶	xdii
薢	xdiiu
藕	xdiiv
薤	xdiivu
携	xdiu
撷	xdiuvo
揳	xdiuvv
偕	xdiv
斜	xdivoo
偰	xdivv
㙦	xdivvo
谢	xdoa
谐	xdoav
写	xdoava
讴	xdoavu
歇	xdoi
躞	xdoio
懈	xdoo
怄	xdoov
叶	xdou
熰	xdouvo
呕	xdov
燮	xdova
亵	xdovi
廨	xdovu
胁	xdua
蟹	xduai
邂	xduao
獬	xduau
血	xdui
协	xduoau
卸	xduv
邪	xdva
榍	xdvav
鞋	xdvi
殴	xdvu
榭	xdvui
鸥	xdvuu
欧	xdvuua
瓯	xdvuv
械	xdvv
絜	xdvva
耦	xdvvi
𤫉	xdvvo
楔	xdvvv
阿	xeaivo
娥	xeau
婀	xeaua
姶	xeaui
涐	xeauv
屙	xeav
蛾	xeia
崿	xeiao
峨	xeiau
萼	xeii
莪	xeiiu
苊	xeiiv
锷	xeio
锇	xeiou
扼	xeiu
俄	xeiuvi
讹	xeoa
谔	xeoao
遏	xeoi
阏	xeoio
愕	xeoo
鄂	xeooa
鹗	xeoou
颚	xeoov
额	xeoovu
哦	xeou
呃	xeovua
鳄	xeua
饿	xeuauv
腭	xeuo
鹅	xeuv
轭	xeva
噩	xevi
垩	xeviv
堨	xevo
厄	xevu
𥔲	xevuo
岸	xfia
黯	xfiao
铵	xfio
盦	xfioi
揞	xfiu
按	xfiuoo
俺	xfiv
谙	xfoa
暗	xfoi
安	xfooau
案	xfoovv
庵	xfov
唵	xfovu
𩽾	xfuao
胺	xfuo
氨	xfuvoo
鞍	xfvioo
桉	xfvo
垵	xfvoo
埯	xfvov
鹌	xfvu
骍	xgaa
陉	xgai
婞	xgau
姓	xgauuv
荥	xgii
荇	xgiiu
铏	xgio
钘	xgiov
擤	xgiu
星	xgoi
兴	xgoo
惺	xgooo
性	xgoouv
悻	xgoov
煋	xgou
猩	xgua
腥	xguoiu
醒	xgvi
幸	xgvo
杏	xgvoo
硎	xgvu
型	xgvv
邢	xgvva
刑	xgvvi
瑆	xgvvo
形	xgvvuu
隘	xhaiou
欸	xhao
嫒	xhau
薛	xhii
蔼	xhiio
茓	xhiioo
艾	xhiiuo
锿	xhioo
挨	xhiu
踅	xhiuo
捱	xhiuv
唉	xhoa
谑	xhoai
哎	xhoi
暧	xhoiu
穴	xhoo
泶	xhooa
学	xhooai
峃	xhooi
嗌	xhoou
嗳	xhou
癌	xhov
哀	xhovou
鳕	xhua
皑	xhuii
爱	xhuovu
矮	xhuv
靴	xhvi
埃	xhvo
毐	xhvoa
雪	xhvoav
霭	xhvoo
碍	xhvu
砹	xhvui
瑷	xhvv
叆	xhvvu
陑	xjai
洱	xjavii
峏	xjia
铒	xjiovi
咡	xjovii
尔	xjua
儿	xjuaa
迩	xjuao
饵	xjuav
鲕	xjuavu
耳	xjviiv
鸸	xjvu
而	xjvuia
耏	xjvuu
贰	xjvv
二	xjvvv
珥	xjvvvi
细	xkaa
绤	xkaau
隙	xkai
隰	xkaio
习	xkao
枲	xkaoo
戏	xkaova
洗	xkau
汐	xkaua
潟	xkaui
溪	xkauo
浠	xkauov
媳	xkauu
嬉	xkauv
犀	xkav
屃	xkava
淅	xkavu
屣	xkavuu
螅	xkia
嶍	xkiaa
酅	xkiaai
巇	xkiai
蟋	xkiau
睎	xkiauo
蜥	xkiav
葸	xkiii
蓰	xkiiu
菥	xkiiv
铣	xkio
锡	xkiooi
傒	xkiu
俙	xkiuo
翕	xkiv
僖	xkivo
禧	xkoa
䜣	xkoau
禊	xkoav
晰	xkoi
曦	xkoio
阋	xkoiui
晞	xkoiuo
暿	xkoiv
惜	xkoo
穸	xkoou
窸	xkoouo
恓	xkoov
吸	xkou
熻	xkoui
唏	xkouo
爔	xkouou
熄	xkouu
烯	xkouuo
羲	xkouuv
粞	xkouv
嘻	xkov
𠅤	xkovi
席	xkovia
夕	xkua
鳛	xkuaa
觿	xkuai
饻	xkuao
饩	xkuau
玺	xkuav
息	xkui
舄	xkuiu
鼷	xkuiuo
希	xkuo
奚	xkuoa
郗	xkuoai
郤	xkuoai
悉	xkuoo
欷	xkuou
谿	xkuouo
兮	xkuov
徙	xkuu
肸	xkuuo
舾	xkuuv
稀	xkuv
膝	xkuvi
牺	xkuvv
樨	xkva
昔	xkvi
西	xkviau
觋	xkvii
熙	xkvio
醯	xkviov
熹	xkvo
憙	xkvoo
喜	xkvooo
囍	xkvovo
析	xkvu
檄	xkvui
袭	xkvuo
皙	xkvuu
矽	xkvuua
豨	xkvuuo
硒	xkvuv
绪	xlaa
湑	xlaai
续	xlaauo
胥	xlai
溆	xlaiv
矞	xlaoi
婿	xlau
絮	xlaua
洫	xlaui
勖	xlia
冔	xliao
盱	xliav
蓄	xlii
蓿	xliio
叙	xliv
虚	xlivii
诩	xloaa
谞	xloaai
煦	xloio
昫	xloiu
旴	xloiv
恤	xloo
噢	xlou
糈	xloua
呴	xlouao
序	xlov
吁	xlovv
旭	xlua
魆	xlui
徐	xluu
媭	xluua
须	xluuvu
栩	xlva
酗	xlvi
醑	xlvia
墟	xlvo
垿	xlvoo
需	xlvovu
戌	xlvu
顼	xlvv
珝	xlvva
缐	xmaau
线	xmaavv
限	xmai
险	xmaii
陷	xmaiu
嫌	xmau
涎	xmaui
孅	xmauii
娴	xmauo
弦	xmav
岘	xmia
县	xmiaao
蚬	xmiai
崄	xmiaiv
盷	xmiaua
仙	xmii
贤	xmiia
苋	xmiii
藓	xmiiu
锨	xmio
伭	xmiov
掀	xmiu
挦	xmiuav
禒	xmoaa
呣	xmoaao
祆	xmoav
闲	xmoi
㬎	xmoia
显	xmoiii
暹	xmoio
跹	xmoiu
鹇	xmoiua
跣	xmoiuv
宪	xmoo
忺	xmoou
羡	xmou
籼	xmoui
痫	xmov
冼	xmovu
呒	xmovv
馅	xmua
猃	xmuai
鲜	xmuaou
狝	xmuau
𤞤	xmuav
献	xmuo
腺	xmuu
衔	xmuui
舷	xmuuo
氙	xmuv
筅	xmuvu
先	xmuvua
酰	xmvi
霰	xmvo
咸	xmvu
燹	xmvuo
现	xmvvia
恩	xniaoa
蒽	xnii
摁	xniuia
嗯	xnoiav
盎	xpiaia
昂	xpoiua
肮	xpuovu
绣	xqaauv
滫	xqai
溴	xqau
岫	xqia
䗛	xqiai
脩	xqii
修	xqiiua
锈	xqio
鸺	xqiv
休	xqivv
袖	xqoa
咻	xqoi
嗅	xqou
羞	xqouai
庥	xqov
馐	xqua
貅	xquo
秀	xquvau
髹	xqvi
琇	xqvv
朽	xqvvaa
珛	xqvvv
遐	xsav
翈	xsiaa
瞎	xsiao
峡	xsiav
黠	xsiavo
锕	xsio
侠	xsivou
啊	xsoaiv
暇	xsoi
呷	xsoia
吖	xsoo
狎	xsua
狭	xsuavo
罅	xsuv
腌	xsuvu
辖	xsva
匣	xsvi
柙	xsvia
下	xsvioo
霞	xsvo
夏	xsvuua
硖	xsvuv
瑕	xsvv
绚	xtaa
漩	xtao
渲	xtaooa
泫	xtaov
眩	xtia
翾	xtiaa
悬	xtiaoa
萱	xtii
儇	xtiia
铉	xtio
镟	xtioo
揎	xtiu
谖	xtoa
禤	xtoai
暄	xtoi
昡	xtoio
暅	xtoioo
暶	xtoiov
晅	xtoiv
喧	xtoo
吅	xtooo
愃	xtoooo
宣	xtoovo
炫	xtou
煊	xtouo
烜	xtouv
旋	xtov
玄	xtova
痃	xtovo
咺	xtovoi
癣	xtovu
衒	xtuuov
选	xtuvoa
轩	xtva
楦	xtvo
碹	xtvu
瑄	xtvv
璿	xtvvi
玹	xtvvo
琄	xtvvou
璇	xtvvov
驯	xwaa
巡	xwaaoa
汛	xwaav
浔	xwaavv
逊	xwai
洵	xwau
迅	xwav
巽	xwavv
寻	xwavvi
峋	xwia
荀	xwii
薰	xwiiuv
蕈	xwiiv
讯	xwoa
勋	xwoaa
诶	xwoaao
询	xwoau
训	xwoaui
噀	xwoav
曛	xwoi
恂	xwoo
窨	xwooo
旬	xwua
鲟	xwuaa
獯	xwuau
徇	xwuu
循	xwuuuu
熏	xwuv
醺	xwvi
埙	xwvo
栒	xwvu
殉	xwvuua
珣	xwvv
飨	xxaa
骧	xxaao
乡	xxaauu
缃	xxaav
湘	xxav
蟓	xxia
芗	xxii
葙	xxiiv
镶	xxio
像	xxiuai
详	xxoa
祥	xxoao
翔	xxou
响	xxouia
鲞	xxouu
享	xxov
襄	xxovo
庠	xxovou
象	xxua
饷	xxuau
向	xxuioo
香	xxuv
箱	xxuvv
项	xxvi
相	xxviav
想	xxvioa
厢	xxvu
橡	xxvua
珦	xxvv
瓖	xxvvo
熊	xyaooo
汹	xyauoa
芎	xyiiav
讻	xyoa
诇	xyoai
兄	xyouaa
匈	xyua
夐	xyuau
凶	xyuo
胸	xyuuau
雄	xyvuio
隩	xzai
媪	xzau
澳	xzauia
傲	xzivvi
袄	xzoa
懊	xzoo
嗷	xzov
鏖	xzovi
廒	xzovv
翱	xzuiao
奥	xzuivu
岙	xzuv
坳	xzvo
奡	xzvu
鳌	xzvv
骜	xzvva
螯	xzvvi
嶅	xzvvia
鏊	xzvvio
遨	xzvvo
熬	xzvvoo
敖	xzvvu
獒	xzvvv
聱	xzvvvi
璈	xzvvvv
骃	ybaa
阴	ybai
洇	ybaia
隐	ybaiu
淫	ybau
姻	ybaui
溵	ybauu
尹	ybav
引	ybavii
蚓	ybia
崟	ybiai
蟫	ybiav
因	ybiavu
荫	ybii
茵	ybiii
茚	ybiiu
铟	ybio
银	ybioav
龂	ybivu
吲	yboa
冘	yboau
禋	yboav
吟	yboi
訚	yboio
寅	yboo
愔	ybooov
喑	yboov
嚚	yboovi
瘾	ybov
音	ybovoi
饮	ybua
胤	ybuaa
印	ybuaai
夤	ybuao
狺	ybuaov
䲟	ybuau
殷	ybuu
氤	ybuv
鄞	ybvi
堙	ybvo
霪	ybvoa
垠	ybvoav
慭	ybvoo
珢	ybvv
幼	ydaa
油	ydai
浟	ydaii
游	ydao
又	ydaoo
邮	ydia
幽	ydiaa
蚴	ydiaaa
黝	ydiaaa
蚰	ydiai
蝣	ydiao
囿	ydiav
由	ydiavi
悠	ydii
莜	ydiii
攸	ydiiu
莸	ydiiua
莠	ydiiuv
铀	ydio
铕	ydiov
优	ydiv
卣	ydivi
佑	ydivu
侑	ydivuu
诱	ydoa
呦	ydoaa
祐	ydoav
宥	ydoo
忧	ydoovu
猷	ydou
羑	ydouu
疣	ydov
麀	ydova
鱿	ydua
鲉	yduai
犹	yduavu
牖	ydui
鼬	yduii
釉	yduo
酉	ydvi
柚	ydvia
友	ydvu
尤	ydvua
尢	ydvuaa
右	ydvuoo
有	ydvuuu
槱	ydvv
耰	ydvvv
也	yeaiaa
液	yeaovi
野	yeia
曳	yeiav
邺	yeii
业	yeiiou
铘	yeio
掖	yeiu
揶	yeiuv
倻	yeiv
谒	yeoa
吔	yeoai
咽	yeoi
晔	yeoii
烨	yeoui
冶	yeov
夜	yeoviu
噎	yeovo
馌	yeua
腋	yeuo
爷	yeuoai
耶	yevi
靥	yevu
页	yevuao
椰	yevv
验	yfaa
沇	yfaao
渰	yfai
演	yfao
妍	yfau
沿	yfauao
嫣	yfauv
嬿	yfauvi
淹	yfav
湮	yfavi
漹	yfaviv
滟	yfavv
蜒	yfia
觃	yfiaa
眼	yfiaav
罨	yfiav
蝘	yfiavo
崦	yfiavu
岩	yfiavu
菸	yfii
芫	yfiiv
掩	yfiu
俨	yfiv
虤	yfivi
偃	yfivo
弇	yfivv
甗	yfivva
谚	yfoa
扊	yfoao
谳	yfoau
晏	yfoio
阎	yfoiu
阉	yfoiv
闫	yfoivv
宴	yfoo
唁	yfoov
戭	yfoova
恹	yfoovu
烟	yfou
炎	yfouo
焱	yfouou
焰	yfouu
颜	yfov
彦	yfovu
烻	yfovui
兖	yfovuo
言	yfovvv
胭	yfui
延	yfuiao
鼹	yfuio
衍	yfuu
筵	yfuvu
严	yfvi
鄢	yfvia
燕	yfvio
歅	yfviu
焉	yfviv
酽	yfvivi
盐	yfvo
郾	yfvoa
棪	yfvoo
堰	yfvov
墕	yfvovi
厌	yfvu
檐	yfvua
赝	yfvuao
雁	yfvui
砚	yfvuia
奄	yfvuia
厣	yfvuia
黡	yfvuia
餍	yfvuio
魇	yfvuu
䶮	yfvuv
研	yfvuvv
艳	yfvv
琰	yfvvo
缨	ygaa
瀴	ygaao
滢	ygai
潆	ygaii
溁	ygaiio
婴	ygao
鹦	ygaou
罂	ygaouv
瀛	ygaov
媖	ygau
盈	ygauia
蝇	ygia
营	ygii
萦	ygiia
萤	ygiii
英	ygiiia
蓥	ygiiio
荧	ygiio
莺	ygiiu
䓨	ygiiuv
莹	ygiiv
茔	ygiivo
锳	ygio
撄	ygiu
嘤	ygoa
映	ygoi
影	ygoiuu
赢	ygov
郢	ygova
瘿	ygovao
嬴	ygovo
应	ygovoo
鹰	ygovu
膺	ygovuu
颖	ygua
迎	yguaoa
颍	yguav
媵	yguo
樱	ygva
楹	ygvau
硬	ygvuvi
瑛	ygvv
璎	ygvva
约	yhaaua
瀹	yhai
钺	yhio
钥	yhiouu
龠	yhiv
跃	yhoi
哕	yhoia
曰	yhoii
阅	yhoiou
悦	yhoo
爚	yhou
岳	yhui
刖	yhuii
粤	yhuiv
月	yhuu
籥	yhuv
戉	yhva
越	yhvova
玥	yhvv
樾	yhvvo
乙	ykaa
驿	ykaaa
绎	ykaaao
缢	ykaao
彝	ykaaou
洢	ykai
潩	ykaia
矣	ykao
贻	ykaoa
浥	ykaoai
翼	ykaoi
以	ykaoii
翌	ykaoo
溢	ykaou
羿	ykaov
姨	ykau
漪	ykaua
沂	ykauu
嫕	ykauv
异	ykav
已	ykavaa
亿	ykia
峄	ykiaao
蜴	ykiaoi
佁	ykiaoo
蚁	ykiaou
螠	ykiaou
屹	ykiau
嶷	ykiaua
黟	ykiaua
伊	ykiav
艺	ykii
苡	ykiia
薏	ykiio
仪	ykio
钇	ykioa
铱	ykioo
镒	ykioou
镱	ykioov
㑊	ykiov
依	ykiovu
抑	ykiu
揖	ykiuo
挹	ykiuoa
佾	ykiuou
倚	ykiv
议	ykoa
译	ykoaa
邑	ykoai
谊	ykoao
扆	ykoaov
诣	ykoau
扅	ykoaua
祎	ykoav
易	ykoi
咿	ykoia
呓	ykoii
宜	ykoo
忆	ykooa
怡	ykooao
怿	ykooao
悒	ykooo
噫	ykoov
宧	ykoovi
义	ykou
熠	ykoua
益	ykoui
燚	ykouo
衣	ykov
咦	ykova
翊	ykovao
裔	ykovi
廙	ykovia
意	ykovo
裛	ykovoa
癔	ykovov
毅	ykovu
疫	ykovua
亦	ykovui
旖	ykovuv
弈	ykovv
痍	ykovva
瘗	ykovvo
奕	ykovvu
逸	ykua
肄	ykuaa
饴	ykuaao
猗	ykuav
劓	ykuii
臆	ykuo
刈	ykuoi
乂	ykuoo
鹢	ykuou
役	ykuu
舣	ykuuo
移	ykuv
胰	ykuva
迤	ykuvo
簃	ykuvu
夷	ykva
匜	ykvai
弋	ykvao
轶	ykvau
颐	ykvi
酏	ykvia
勚	ykviau
壹	ykvo
圯	ykvoa
懿	ykvoo
埸	ykvooi
鹝	ykvou
椸	ykvov
翳	ykvu
繄	ykvua
枍	ykvuo
殪	ykvuv
医	ykvuvv
一	ykvv
杙	ykvva
椅	ykvvu
驭	ylaa
滪	ylaao
潏	ylaaoa
纡	ylaav
隅	ylai
隃	ylaii
渝	ylaiv
予	ylao
羽	ylaoa
遹	ylaoo
豫	ylaou
鹬	ylaoua
淤	ylaov
淯	ylaova
预	ylaovu
浴	ylau
渔	ylaua
妤	ylauao
娱	ylauo
妪	ylauv
鬻	ylav
㳚	ylavu
聿	ylavv
遇	ylia
嵛	yliai
嵎	yliaia
髃	yliaia
蝓	yliaiv
愚	yliao
峪	yliau
屿	yliav
圄	yliavi
圉	yliavo
蜮	yliavo
禺	yliavv
芋	ylii
蓣	yliia
萸	yliiu
薁	yliiui
钰	ylio
俣	yliov
揄	yliu
愈	yliv
觎	ylivi
逾	ylivo
悆	ylivoa
虞	ylivov
俞	ylivu
伛	ylivuo
龉	ylivv
余	ylivvv
裕	yloa
哟	yloaa
谕	yloai
褕	yloaiv
谀	yloau
语	yloavi
喻	yloi
喁	yloia
昱	yloio
阈	yloiv
寓	yloo
愉	ylooi
窬	ylooiv
誉	ylooo
窳	yloou
宇	yloov
唷	yloova
煜	ylou
燏	yloua
燠	ylouu
育	ylov
瘀	ylovo
庾	ylovu
瘐	ylovui
狱	ylua
馀	yluai
鱼	yluaia
狳	yluaiv
㺄	yluaiv
饫	yluau
舆	ylui
禹	yluia
鄅	yluiai
臾	yluiv
舁	yluivu
欲	yluo
鹆	yluou
御	yluu
腴	yluui
艅	yluuiv
竽	yluv
毓	yluvo
欤	ylva
与	ylvavv
雨	ylvi
敔	ylviu
榆	ylviv
域	ylvo
堉	ylvoo
圫	ylvou
雩	ylvov
彧	ylvova
郁	ylvu
玉	ylvv
邘	ylvva
瑜	ylvvi
盂	ylvvia
于	ylvvii
迂	ylvvo
棫	ylvvov
瑀	ylvvu
玙	ylvvv
阳	ypai
泱	ypaia
漾	ypao
洋	ypaouv
央	ypia
蛘	ypiao
鸯	ypiau
佯	ypio
钖	ypioa
仰	ypiu
扬	ypiuau
旸	ypoi
咉	ypoia
怏	ypoo
羊	ypou
炀	ypoua
恙	ypouo
羕	ypouoa
烊	ypouou
养	ypouui
痒	ypov
疡	ypova
卬	ypua
飏	ypuaa
徉	ypuu
秧	ypuv
氧	ypuvou
杨	ypvauu
鞅	ypvi
垟	ypvo
样	ypvouv
殃	ypvu
娅	ysau
涯	ysavuv
鸭	ysia
崖	ysiav
岈	ysiava
蚜	ysiava
睚	ysiavu
芽	ysii
蕥	ysiiv
揠	ysiu
押	ysiuia
伢	ysiv
讶	ysoa
丫	ysou
哑	ysov
呀	ysovai
痖	ysovv
猰	ysua
衙	ysuuvi
氩	ysuv
雅	ysva
牙	ysvaiu
迓	ysvao
鸦	ysvau
亚	ysvi
垭	ysvo
堐	ysvov
砑	ysvu
压	ysvuvo
桠	ysvv
枒	ysvva
琊	ysvvv
玡	ysvvva
缘	ytaa
院	ytaioo
贠	ytao
渊	ytau
湲	ytauo
媛	ytauu
嫄	ytauv
源	ytav
沅	ytavv
圆	ytia
蜎	ytiao
螈	ytiav
园	ytiavv
苑	ytii
薳	ytiivo
援	ytiu
掾	ytiua
冤	ytoa
员	ytoaoo
鹓	ytoou
羱	ytou
猿	ytua
眢	ytuai
怨	ytuaoa
鸳	ytuau
爰	ytuo
箢	ytuv
辕	ytva
橼	ytvaa
鸢	ytvau
袁	ytvo
垣	ytvov
塬	ytvovu
愿	ytvu
原	ytvuui
远	ytvv
鼋	ytvvo
瑗	ytvvu
元	ytvvua
纭	ywaa
缊	ywaao
陨	ywai
涢	ywao
允	ywaoua
孕	ywau
妘	ywauv
熨	ywav
㞌	ywavai
沄	ywavv
芸	ywii
蕰	ywiia
蕴	ywiiaa
郧	ywoa
郓	ywoaa
昀	ywoi
晕	ywoioa
愠	ywoo
恽	ywooo
煴	ywou
韵	ywov
赟	ywova
狁	ywua
匀	ywuaov
氲	ywuv
筼	ywuvo
馧	ywuvoi
酝	ywvi
鋆	ywvo
殒	ywvu
耘	ywvv
云	ywvvao
运	ywvvoa
邕	yyaao
泳	yyao
勇	yyaoau
甬	yyaoi
恿	yyaoo
澭	yyaov
蛹	yyia
俑	yyiao
颙	yyiav
镛	yyio
佣	yyiu
拥	yyiuua
永	yyoaau
踊	yyoi
咏	yyoo
慵	yyooo
㶲	yyou
庸	yyov
雍	yyova
鄘	yyovai
饔	yyovi
痈	yyovu
壅	yyovv
鳙	yyua
鲬	yyuaa
用	yyuavv
臃	yyuova
栐	yyvo
埇	yyvoa
墉	yyvoov
幺	yzaa
滧	yzao
姚	yzau
媱	yzauu
妖	yzauuv
崾	yzia
峣	yziav
药	yziiaa
耀	yzio
摇	yziu
谣	yzoa
吆	yzoaa
曜	yzoi
窑	yzoo
窈	yzooa
窅	yzooi
咬	yzoovu
鳐	yzua
猺	yzuau
邀	yzui
遥	yzuo
舀	yzuou
鹞	yzuoua
爻	yzuouo
肴	yzuov
徭	yzuu
夭	yzuv
腰	yzuvia
尧	yzva
轺	yzvaa
靿	yzvaaa
要	yzviau
杳	yzvo
垚	yzvov
㙘	yzvovi
珧	yzvv
瑶	yzvvuo
罪	zbiaiv
蕞	zbii
觜	zbiv
嘴	zboivi
最	zboivi
槜	zbvi
醉	zbviov
驺	zdaaua
陬	zdai
揍	zdiuvv
诹	zdoavi
鲰	zdua
邹	zduaai
鄹	zdvi
走	zdvoiv
奏	zdvvvv
泽	zeaaov
则	zeaoii
帻	zeia
昃	zeoi
啧	zeov
舴	zeuuuv
迮	zeuv
笮	zeuvu
箦	zeuvv
赜	zevi
仄	zevu
责	zevvao
拶	zfiu
寁	zfoo
糌	zfou
咱	zfouia
昝	zfua
簪	zfuv
赞	zfuvao
錾	zfva
暂	zfvaoi
趱	zfvo
瓒	zfvv
甾	zhaaia
崽	zhia
仔	zhiaiv
宰	zhoo
灾	zhooou
栽	zhuo
哉	zhuoo
载	zhuova
再	zhviai
在	zhvuvo
组	zjaaia
阻	zjaiia
崒	zjia
菹	zjii
俎	zjiiia
镞	zjio
祖	zjoa
诅	zjoai
足	zjoivu
族	zjov
租	zjuvia
珇	zjvvia
淄	zkaa
缁	zkaaa
孜	zkai
子	zkaivv
滋	zkao
滓	zkaoo
姊	zkau
渍	zkav
虸	zkiaa
眦	zkiai
嵫	zkiao
锱	zkio
镃	zkioo
龇	zkiv
赀	zkiva
紫	zkivaa
訾	zkivo
谘	zkoa
嗞	zkoo
字	zkooai
孳	zkoua
籽	zkouai
姿	zkov
资	zkovao
咨	zkovo
恣	zkovoa
粢	zkovou
鲻	zkua
自	zkuiav
笫	zkuv
秭	zkuvu
辎	zkva
髭	zkvi
鄑	zkvia
鼒	zkvii
趑	zkvo
梓	zkvovo
耔	zkvv
阼	zlaiuv
岞	zlia
坐	zlii
做	zliuoo
捽	zliuov
作	zliuvi
佐	zliv
祚	zloa
昨	zloi
唑	zloii
座	zlovii
胙	zluuvi
柞	zlvu
左	zlvuvi
谮	znoava
怎	znuvoa
驵	zpaa
牂	zpaio
赃	zpaoov
葬	zpiivu
脏	zpuovu
缯	zraa
综	zraao
赠	zraoou
罾	zria
锃	zrioov
憎	zroo
甑	zrou
鄫	zroua
䎖	zrouao
矰	zruvou
增	zrvoou
咂	zsov
杂	zsuavv
臜	zsuo
匝	zsvi
砸	zsvuvi
缵	ztaa
钻	ztioiv
攥	ztiu
躜	ztoiuv
纂	ztuvia
贼	zwaovv
嶟	zwia
僔	zwio
𨱔	zwioo
撙	zwiuou
噂	zwoo
遵	zwou
尊	zwouvi
鲗	zwua
鳟	zwuaou
樽	zwvouv
纵	zyaaii
倧	zyio
偬	zyiuau
踪	zyoi
宗	zyoovv
粽	zyou
总	zyouoa
疭	zyov
腙	zyuooa
鬃	zyvi
鬷	zyvo
棕	zyvooa
蚤	zzao
澡	zzaooo
凿	zzii
藻	zziiao
躁	zzoi
早	zzoiuo
噪	zzoo
慥	zzoou
灶	zzou
唣	zzoui
糟	zzouvi
皂	zzui
簉	zzuv
造	zzuvoa
枣	zzvi
遭	zzvioa
𥖨	zzvu
璪	zzvv
猋	bcvuv
嫑	bcvuvi
兡	bhkeuo
誧	bjovvi
𬷕	bjviu
夶	bkvuv
𬭛	blioa
𫚖	ckivu
壿	cwvo
瑽	cyvvuu
弔	dcavai
𫶇	ddiav
𬘘	dfaa
𫢸	dfio
呾	dfooiv
𬊤	dfouo
𬭊	djiov
𬱖	dkiavu
𬤊	dkoaoi
𬍡	dpaa
𫟼	dsiov
墫	dwvoo
𬟽	dyiava
𪨶	eeiav
𫮃	efvoou
𬬸	ejio
兙	ekkeuo
𫚕	ekuaiu
𬳽	enaau
𬬹	enio
𫔍	ffiou
𬸪	ffuou
蝜蝂	fjbfi
蝜	fjiaua
𫓧	fjiov
𫖯	fjuovu
𫄨	fkaauo
蹠	fkoiov
㩼	fkuauo
𬃊	fkvuuu
𬸦	flovu
𮝷	fnva
甴	fsia
𬬿	fzioa
𬶐	fzua
佮	geiivo
𬕂	gfuvvi
𬮿	ghaii
巭	gjviv
𬇹	glai
菓	glii
畊	griavv
㹴	grua
𬒔	grvu
兝	gyfnuo
𬤝	hboavi
𬭤	hdio
𬌗	heva
𬴃	hlaa
𬣳	hnoaa
椛	hqviii
𬘫	htaao
𬭶	hwio
𫟹	hyio
𬭎	hyioo
兞	hzkeuo
䜰	hzuoui
𬬱	jbiouu
苂	jfiiou
丼	jgvvoo
𫘝	jhaa
𫔎	jhioao
𬺓	jjiv
𬯀	jkaio
𬶨	jkavua
𫓯	jkiov
𫓹	jkiovi
𫌀	jkoavv
𬶭	jkuaua
檵	jkvaao
𪟝	jkvva
𬶋	jluau
𬣡	jmoavv
𬘭	jnaa
𬬮	jpiouv
嗧	jslwau
𬂩	jsvvou
𫓶	jtioou
奆	jtvuva
𫖳	jwavv
𬭚	jwioo
𬳶	jyaai
𫠆	kbuo
𫸩	kdavvu
𫛭	kxua
𬴊	lbaao
𬭸	lbioo
𪤗	lcvo
𫚭	ldua
𪣻	ldvoo
𬒗	lfvu
𫵷	lhiavu
𫘧	ljaaa
𬬻	ljioi
兣	lkkeuo
糎	lkmkou
𬍛	lkvvua
𬶠	lmuav
瑠	lqvvua
𬶟	lsua
𬬭	lwioi
𫭢	lwvoi
𫟅	lxaao
𬜯	lxiiv
䜮	lzuooo
𫭼	lzvo
𬇕	mfav
𬜬	mfiio
鿏	mhio
𬭁	mjioa
𬙊	mlaa
𫞩	mnvv
𫑡	mroa
冇	mzvuia
𫔶	ndoiu
𫠜	nkiv
𫐐	nkva
鲶	nmuaio
挊	nyiu
𬪩	nyvi
𬞟	pbii
𬭯	pdio
𬳵	pkaav
𬇙	pwaao
骹	qciaov
𫗴	qfuao
𬘬	qgaa
𬒈	qhoovu
礐	qhuivu
𬣞	qjoao
炁	qkvao
𬨂	qkvau
𪨰	qliaia
兛	qmkeuo
粁	qmmkou
瓩	qmwsva
姫	qnau
𬘯	qwaa
𫐓	rdva
叒	rlao
𬭼	sbio
𫟦	sbva
𫗧	sjuavi
亖	skvvv
惢	sloaoa
𪨊	syav
𬯎	tbai
𬘩	tgaa
𡘙	thvu
𬳿	tjaa
𫘨	tkaaoi
薙	tkiiu
𬶍	tluao
𫍣	tyoai
𫘦	tzaaua
卍	wfaivi
卐	wfaviv
喎	whoiaa
翄	wkao
𫘜	wnaao
歘	wqou
𬭩	wrio
𫇭	wwiio
𬭬	wwiov
𬀩	wwoivv
𬶏	wwuau
𬱟	wwuavu
𫷷	xbovi
枔	xbvioa
𫍲	xcoau
𬹼	xdivi
𬉼	xdouv
𫭟	xdvo
𫫇	xeovi
𫰛	xgaua
𫘬	xkaau
𬭳	xkiov
𬶮	xkuavo
卌	xkviii
𬣙	xloav
𫄧	xmaaui
𪾢	xmiaia
𫍯	xmoavu
𬀪	xmoii
𬸣	xmooua
𫠊	xtaao
𫍽	xtoaia
譞	xtovi
𬘓	xwaaui
𫄸	xwaauv
𬩽	xwava
𬊈	xwou
𬍤	xwvva
𬙋	xxaaov
𬘡	ybaai
𬤇	yboavi
𬮱	yboiv
烎	ybvvou
𬨎	ydva
嘢	yeoiav
鵺	yeovui
𬙂	yfaaoo
𪩘	yfiauo
昖	yfoiuo
喦	yfooia
𬸘	yfvoua
桜	ygvo
曱	yhia
𬸚	yhua
𫐄	yhva
𫄷	ykaaov
𫖮	ykiavu
𬟁	ykiivo
𬬩	ykiova
𬺈	ykivv
弌	ykvvao
犽	ysuava
𫘪	ytaav
円	ytiaiv
橒	ywvvoa
囃	zsovii
𭎂	zyvo
艸	cza
吰	hyo
：	xxo
“	xxo
遯	dwu
醲	nyv
嘸	xmo
蝦	xsi
昚	env
？	xxo
9	jqo
8	bso
6	lqo
3	sfo
䦆	jhi
內	nwi
沢	zea
鞌	xfo
！	xxo
2	xjo
1	yko
